There was once a young man named Jack who lived in a small village. Jack was often the subject of ridicule and laughter because he was different from everyone else. He was clumsy and awkward, and he often stumbled and fell when he walked. Despite this, Jack had a kind and generous heart, and he always tried to help others whenever he could. One day, a rumor spread through the village that a beautiful princess had been captured by a dragon and locked away in a castle. The villagers were afraid to try and rescue the princess, but Jack knew he had to do something. He knew he was no match for the dragon, but he also knew that he couldn't just stand by and do nothing. Despite the laughter and ridicule of the other villagers, Jack set out on a journey to rescue the princess. You are Jack. You are in forest now.

Igra
An Interactive Fiction by Ivona Kostic
Release 1 / Serial number 230108 / Inform 7 v10.1.2 / D

forest
You are standing in a dense forest. The trees are tall and their branches form a canopy overhead, blocking out most of the sunlight. There is a faint path winding through the underbrush, leading east and west.

(From here, you can move to the east.)

>e
You can't go that way.

>w
You can't go that way.

>go east
Which do you mean, the east or the East Path?

>the East Pathđ
I only understood you as far as wanting to go The West Path.

>the East Path
I only understood you as far as wanting to (go) The West Path.

>go
You'll have to say which compass direction to go in.

>the East Path
I only understood you as far as wanting to (go) The West Path.

>go west
Which do you mean, the west or The West Path?

>the west
Which do you mean, the west or The West Path?

>the west path
You can't go that way.

* * *

>east
You follow the east path deeper into the forest and got to the old house.

house
You are now in the old house. It looks like it has been abandoned for some time, but it is still in good repair. There is a male person standing.

It is salesman, who is standing in front of the table, on which are  several gadgets and weaponry. He stares at you intently. You can ask him about the things on the table.

You can also see a table (on which are a sword, a knife and a flaming torch) here.

(From here, you can move to the north and the west.)

* * *

>ask salesman about the things inside briefcase
I am selling weaponry and gadget

* * *

>ask salesman about the sword
It costs 20 coins

>buy sword
You can't see any such thing.

>buy the sword
You can't see any such thing.

>buy the flaming torch
You can't see any such thing.

>buy flaming torch
You can't see any such thing.

>examine
(the Salesman)
You see nothing special about the Salesman.

* * *

>east
You follow the east path deeper into the forest and got to the old house.

house
You are now in the old house. It looks like it has been abandoned for some time, but it is still in good repair. There is a male person standing.

It is salesman, who is standing in front of the table, on which are  several gadgets and weaponry. He stares at you intently. You can ask him about the things on the table.

You can also see a table (on which are a sword, a knife and a flaming torch) here.

(From here, you can move to the north and the west.)

>ask salesman about the knife
It costs 5 dollars

>buy the knife
You do not have wallet or money with you

>north
castle
You are now in front of castle. In order to get into the castle you need to open the Castle Door.

You can see a Castle Door here.

(From here, you can move to the north, the south, the east, the west and the inside.)

>inside
The Castle Door is locked.
Search for the key in the garage.

>west
garden
You are now in the garden.

Here is a huge box made of wood with a hinged lid. It is well-worn, with scratches and dents on its surface. It looks like it has been used for storing things for a long time. You can open it and see what is inside.

(From here, you can move to the east.)

>open box
You open the box, revealing bag.

>open bag
You open bag, revealing a wallet.

>take wallet
Amazing, you have money. You can buy items in the old house.

>open wallet
You open the wallet, revealing 20 dollar bills.

>east
castle
You are now in front of castle. In order to get into the castle you need to open the Castle Door.

You can see a Castle Door here.

(From here, you can move to the north, the south, the east, the west and the inside.)

>east
It is dark in here, I can not see in dark.
The player can not enter garage.
Only way to get inside is, if you have flaming torch
Darkness
It is pitch dark, and you can't see a thing.

(From here, you can move to the west.)

>west
castle
You are now in front of castle. In order to get into the castle you need to open the Castle Door.

You can see a Castle Door here.

(From here, you can move to the north, the south, the east, the west and the inside.)

>south
house
You are now in the old house. It looks like it has been abandoned for some time, but it is still in good repair. There is a male person standing.

It is salesman, who is standing in front of the table, on which are  several gadgets and weaponry. He stares at you intently. You can ask him about the things on the table.

You can also see a table (on which are a sword, a knife and a flaming torch) here.

(From here, you can move to the north and the west.)

>buy flaming torch
Salesman says: You can buy the the sword, the flaming torch or the knife if you have enough money

I want to buy the flaming torch

You hand over cash, now you have 10 dollars remaining.
You take the flaming torch from the salesman.

>nort
That's not a verb I recognise.

>north
castle
You are now in front of castle. In order to get into the castle you need to open the Castle Door.

You can see a Castle Door here.

(From here, you can move to the north, the south, the east, the west and the inside.)

>east
You can see everything. Now you can search for key
garage
You are in the garage. It is a large, cluttered space with a concrete floor and fluorescent lighting.

Here is also the smart fox which is a small, animal with bright, alert eyes, and a bushy tail. It looks sly and cunning, with a sharp, curious gaze that seems to suggest that it is always thinking.

You can also see a cabinet and a rug here.

(From here, you can move to the west.)

>examine cabinet
It is made of sturdy oak and has a smooth, polished finish.

>look under rug
You picked roses from the vase and can see the nickel key. Keep the key

>inventory
You are carrying:
  a nickel key
  a flaming torch (providing light)
  a wallet (open)
    20 dollar bills

>east
You can't go that way.

>west
castle
You are now in front of castle. In order to get into the castle you need to open the Castle Door.

You can see a Castle Door here.

(From here, you can move to the north, the south, the east, the west and the inside.)

>north
(first opening the Castle Door)
hallway
You can see a Castle Door, Door 1 and Door 2 here.

(From here, you can move to the south, the inside and the outside.)

>door 1
You open Door 1.

kitchen
You are in the castle's kitchen. It is a large, well-equipped space with a fireplace, a fridge, and a table in the center. The smell of cooking food fills the air.

The old fridge is a large, white appliance with a dented surface and a handle on the door. It has three cakes inside.

(From here, you can move to the outside.)

>open fridge
I am very hungry. I want to eat dobosica

>eat dobosica
You are poisoned  and have to find a cure if you want to live. The fox has the cure.

(first taking the dobosica)
You eat the dobosica. Not bad.

>out
hallway
You can see a Castle Door, Door 1 and Door 2 here.

(From here, you can move to the south, the inside and the outside.)

>out
castle
You are now in front of castle. In order to get into the castle you need to open the Castle Door.

You can see a Castle Door here.

(From here, you can move to the north, the south, the east, the west and the inside.)

>east
You can see everything. Now you can search for key
garage
You are in the garage. It is a large, cluttered space with a concrete floor and fluorescent lighting.

Here is also the smart fox which is a small, animal with bright, alert eyes, and a bushy tail. It looks sly and cunning, with a sharp, curious gaze that seems to suggest that it is always thinking.

You can also see a cabinet and a rug here.

(From here, you can move to the west.)

>west
castle
You are now in front of castle. In order to get into the castle you need to open the Castle Door.

You can see a Castle Door here.

(From here, you can move to the north, the south, the east, the west and the inside.)

>west
garden
You are now in the garden.

Here is a huge box made of wood with a hinged lid. It is well-worn, with scratches and dents on its surface. It looks like it has been used for storing things for a long time. You can open it and see what is inside.

(From here, you can move to the east.)

>east
castle
You are now in front of castle. In order to get into the castle you need to open the Castle Door.

You can see a Castle Door here.

(From here, you can move to the north, the south, the east, the west and the inside.)

>east
You can see everything. Now you can search for key
garage
You are in the garage. It is a large, cluttered space with a concrete floor and fluorescent lighting.

Here is also the smart fox which is a small, animal with bright, alert eyes, and a bushy tail. It looks sly and cunning, with a sharp, curious gaze that seems to suggest that it is always thinking.

You can also see a cabinet and a rug here.

(From here, you can move to the west.)

>examine fox
Hello smart fox, I am poisoned and need the cure. Can you help me?. Fox says: Yes, but you need to answer this riddle. What invention lets you look right through a wall? 
You see nothing special about the fox.

Enter the answer:

>donr know
The fox says: That's wrong, can't give you cure

>examine fox
Hello smart fox, I am poisoned and need the cure. Can you help me?. Fox says: Yes, but you need to answer this riddle. What invention lets you look right through a wall? 
You see nothing special about the fox.

Enter the answer:

>a window
The fox says: You are right, here is cure

>inventory
You are carrying:
  a cure
  a nickel key
  a flaming torch (providing light)
  a wallet (open)
    20 dollar bills

>drink cure
You slurp down the cure. Refreshing!

That isn't available.

>inventory
You are carrying:
  a nickel key
  a flaming torch (providing light)
  a wallet (open)
    20 dollar bills

>west
castle
You are now in front of castle. In order to get into the castle you need to open the Castle Door.

You can see a Castle Door here.

(From here, you can move to the north, the south, the east, the west and the inside.)

* * *

>north
(first opening the Castle Door)
hallway
You can see a Castle Door, Door 1 and Door 2 here.

(From here, you can move to the south, the inside and the outside.)

>door 1
kitchen
You are in the castle's kitchen. It is a large, well-equipped space with a fireplace, a fridge, and a table in the center. The smell of cooking food fills the air.

The old fridge is a large, white appliance with a dented surface and a handle on the door. It has three cakes inside.

(From here, you can move to the outside.)

>open fridge
That's already open.

>examine firdge
You can't see any such thing.

>look in fridge
In the fridge are a cheesecake and a chocolate cake.

>inventory
You are carrying:
  a nickel key
  a flaming torch (providing light)
  a wallet (open)
    20 dollar bills

>out
hallway
You can see a Castle Door, Door 1 and Door 2 here.

(From here, you can move to the south, the inside and the outside.)

>door 2
You are in Princesses room, but you can see enormous dragon that is very hungry.

    *** Dragon ate you, because you did not bring him any food. GAME OVER ***

Would you like to RESTART, RESTORE a saved game, QUIT or UNDO the last command?

>undo
hallway
[Previous turn undone.]

>door 1
kitchen
You are in the castle's kitchen. It is a large, well-equipped space with a fireplace, a fridge, and a table in the center. The smell of cooking food fills the air.

The old fridge is a large, white appliance with a dented surface and a handle on the door. It has three cakes inside.

(From here, you can move to the outside.)

>look in fridge
In the fridge are a cheesecake and a chocolate cake.

>examine cheescake
You can't see any such thing.

>look cheesecake
You see nothing special about the cheesecake.

>take cocolate cake
You can't see any such thing.

>take cohcolate cake
You can't see any such thing.

>take chocolate cake
Taken.

>out
hallway
You can see a Castle Door, Door 1 and Door 2 here.

(From here, you can move to the south, the inside and the outside.)

* * *

>east
You follow the east path deeper into the forest and got to the old house.

house
You are now in the old house. It looks like it has been abandoned for some time, but it is still in good repair. There is a male person standing.

It is salesman, who is standing in front of the table, on which are  several gadgets and weaponry. He stares at you intently. You can ask him about the things on the table.

You can also see a table (on which are a sword, a knife and a flaming torch) here.

(From here, you can move to the north and the west.)

>ask salesman about things
I am selling weaponry and gadget

>examine table
On the table are a sword, a knife and a flaming torch.

* * *

>ask salesman about the knife
It costs 5 dollars

>buy knife
You do not have wallet or money with you

>north
castle
You are now in front of castle. In order to get into the castle you need to open the Castle Door.

You can see a Castle Door here.

(From here, you can move to the north, the south, the east, the west and the inside.)

>north
(first opening the Castle Door)
The Castle Door is locked.
Search for the key in the garage.

>east
The player can not enter garage.
Only way to get inside is, if you have flaming torch
Darkness
It is pitch dark, and you can't see a thing.

(From here, you can move to the west.)

>west
castle
You are now in front of castle. In order to get into the castle you need to open the Castle Door.

You can see a Castle Door here.

(From here, you can move to the north, the south, the east, the west and the inside.)

* * *

>take wallet
Amazing, you have money. You can buy items in the old house.

>east
castle
You are now in front of castle. In order to get into the castle you need to open the Castle Door.

You can see a Castle Door here.

(From here, you can move to the north, the south, the east, the west and the inside.)

>south
house
You are now in the old house. It looks like it has been abandoned for some time, but it is still in good repair. There is a male person standing.

It is salesman, who is standing in front of the table, on which are  several gadgets and weaponry. He stares at you intently. You can ask him about the things on the table.

You can also see a table (on which are a sword, a knife and a flaming torch) here.

(From here, you can move to the north and the west.)

* * *

>buy flaming torch
Salesman says: You can buy the the sword, the flaming torch or the knife if you have enough money

I want to buy the flaming torch

You hand over cash, now you have 10 dollars remaining.
You take the flaming torch from the salesman.

>open wallet
You open the wallet, revealing 20 dollar bills.

>buy sword
Salesman says: You can buy the the sword, the flaming torch or the knife if you have enough money

Sorry, but you do not have enough money to buy the sword

>north
castle
You are now in front of castle. In order to get into the castle you need to open the Castle Door.

You can see a Castle Door here.

(From here, you can move to the north, the south, the east, the west and the inside.)

* * *

>east
You can see everything. Now you can search for key
garage
You are in the garage. It is a large, cluttered space with a concrete floor and fluorescent lighting.

Here is also the smart fox which is a small, animal with bright, alert eyes, and a bushy tail. It looks sly and cunning, with a sharp, curious gaze that seems to suggest that it is always thinking.

You can also see a cabinet and a rug here.

(From here, you can move to the west.)

>search cabinet
You find nothing of interest.

>examine cabinet
It is made of sturdy oak and has a smooth, polished finish.

>open cabinet
It isn't something you can open.

>open drawer
That's already open.

>search drawer
In the drawer is a paper.

>read paper
In the paper is a message.

>read message
MESSAGE: In fridge are three cakes, only chocolate cake is not poisonous.

>look under rug
You saw a nickel key under the rug. Keep the key

>east
You can't go that way.

* * *

>north
(first opening the Castle Door)
hallway
You can see a Castle Door, Door 1 and Door 2 here.

(From here, you can move to the south, the inside and the outside.)

>castle door
That's not a verb I recognise.

>door 1
You open Door 1.

kitchen
You are in the castle's kitchen. It is a large, well-equipped space with a fireplace, a fridge, and a table in the center. The smell of cooking food fills the air.

The old fridge is a large, white appliance with a dented surface and a handle on the door. It has three cakes inside.

(From here, you can move to the outside.)

* * *

>open fridge
I am very hungry. I want to eat dobosica

>eat dobosica
(first taking the dobosica)
You're carrying too many things already.

>drop wallet
Dropped.

>eat dobosica
(first taking the dobosica)
I am full now.

You are poisoned and have to find a cure if you want to live. The fox has the cure.

>out
hallway
You can see a Castle Door, Door 1 and Door 2 here.

(From here, you can move to the south, the inside and the outside.)

* * *

>east
You can see everything. Now you can search for key
garage
You are in the garage. It is a large, cluttered space with a concrete floor and fluorescent lighting.

Here is also the smart fox which is a small, animal with bright, alert eyes, and a bushy tail. It looks sly and cunning, with a sharp, curious gaze that seems to suggest that it is always thinking.

You can also see a cabinet and a rug here.

(From here, you can move to the west.)

>examine fox
Hello smart fox, I am poisoned and need the cure. Can you help me?.
Fox says:  Yes, but you need to answer this riddle. 
What invention lets you look right through a wall? 
Enter the answer:

>a window
The fox says: You are right, here is cure

>drink cure
You slurp down the cure. Refreshing!

>west
castle
You are now in front of castle. In order to get into the castle you need to open the Castle Door.

You can see a Castle Door here.

(From here, you can move to the north, the south, the east, the west and the inside.)

A starvation occurs in ten minutes from now

>north
(first opening the Castle Door)
hallway
You can see a Castle Door, Door 1 and Door 2 here.

(From here, you can move to the south, the inside and the outside.)

>door 1
kitchen
You are in the castle's kitchen. It is a large, well-equipped space with a fireplace, a fridge, and a table in the center. The smell of cooking food fills the air.

The old fridge is a large, white appliance with a dented surface and a handle on the door. It has three cakes inside.

You can also see a wallet (in which is 20 dollar bills) here.

(From here, you can move to the outside.)

>eat chocolate cake
(first taking the chocolate cake)
I am full now.

You eat the chocolate cake. Not bad.

>out
hallway
You can see a Castle Door, Door 1 and Door 2 here.

(From here, you can move to the south, the inside and the outside.)

* * *

>undo
hallway
[Previous turn undone.]

>door 1
kitchen
You are in the castle's kitchen. It is a large, well-equipped space with a fireplace, a fridge, and a table in the center. The smell of cooking food fills the air.

The old fridge is a large, white appliance with a dented surface and a handle on the door. It has three cakes inside.

You can also see a wallet (in which is 20 dollar bills) here.

(From here, you can move to the outside.)

* * *

>out
hallway
You can see a Castle Door, Door 1 and Door 2 here.

(From here, you can move to the south, the inside and the outside.)

>door 2
You are in Princesses room, but you can see enormous dragon that is very hungry.

You open Door 2.

Princesses Room
You entered her room, but there is enormous dragon that is very hungry. Give him poisonus cake that will kill it and save princess

The dragon is a massive, fearsome beast. It has wings that stretch out wide, and its eyes are glowing, fiery orbs. It looks like it is full of hatred and malice, and it seems to relish the thought of causing destruction and chaos.

The princess is standing in the back of the room, she is looking scared.

(From here, you can move to the outside.)

>feed dragon with cake
You feed the dragon with cake. It is munching it down.

    *** You killed dragon with poisonous cake and saved princess. YOU WON ***

Would you like to RESTART, RESTORE a saved game, QUIT or UNDO the last command?

* * *

>east
You follow the east path deeper into the forest and got to the old house.

house
You are now in the old house. It looks like it has been abandoned for some time, but it is still in good repair. There is a male person standing.

It is salesman, who is standing in front of the table, on which are  several gadgets and weaponry. He stares at you intently. You can ask him about the things on the table.

You can also see a table (on which are a sword, a knife and a flaming torch) here.

(From here, you can move to the north and the west.)

>buy flaming torch
You do not have wallet or money with you

>buy the sword
Nothing is on sale.

* * *

>buy flaming torch
You do not have wallet or money with you

>north
castle
The walls are made of stone, and the floors are polished marble. There are various doors and hallway leading off in different directions.

You can see a Castle Door here.

>west
garden
You are now in the garden.

Here is a huge box made of wood with a hinged lid. It is well-worn, with scratches and dents on its surface. It looks like it has been used for storing things for a long time. You can open it and see what is inside.

>open boy
You can't see any such thing.

>open box
You open the box, revealing bag.

* * *

>take wallet
Amazing, you have money. You can buy items in the old house.

>east
castle
The walls are made of stone, and the floors are polished marble. There are various doors and hallway leading off in different directions.

You can see a Castle Door here.

>south
house
You are now in the old house. It looks like it has been abandoned for some time, but it is still in good repair. There is a male person standing.

It is salesman, who is standing in front of the table, on which are  several gadgets and weaponry. He stares at you intently. You can ask him about the things on the table.

You can also see a table (on which are a sword, a knife and a flaming torch) here.

>buy flaming torch
You can buy the the sword, the flaming torch or the knife
You hand over cash, now you have 10 dollars remaining. You take the flaming torch from the salesman.

>buy knife
You can buy the the sword, the flaming torch or the knife
You hand over cash, now you have 5 dollars remaining.
You take the knife from the salesman.

>buy sword
You can buy the the sword, the flaming torch or the knife
You do not have enough money to buy the sword

* * *

>east
You follow the east path deeper into the forest and got to the old house.

house
You are now in the old house. It looks like it has been abandoned for some time, but it is still in good repair. There is a male person standing.

It is salesman, who is standing in front of the table, on which are  several gadgets and weaponry. He stares at you intently. You can ask him about the things on the table.

You can also see a table (on which are a sword, a knife and a flaming torch) here.

(From here, you can move to the north and the west.)

>buy knife
You do not have wallet or money with you
Nothing is on sale.

>north
castle
The walls are made of stone, and the floors are polished marble. There are various doors and hallway leading off in different directions.

You can see a Castle Door here.

* * *

>open box
You open the box, revealing bag.

>open bag
You open bag, revealing wallet.

>take wallet
Amazing, you have money. You can buy items in the old house.

* * *

>south
house
You are now in the old house. It looks like it has been abandoned for some time, but it is still in good repair. There is a male person standing.

It is salesman, who is standing in front of the table, on which are  several gadgets and weaponry. He stares at you intently. You can ask him about the things on the table.

You can also see a table (on which are a sword, a knife and a flaming torch) here.

>buy knife
Nothing is on sale.

>buy the knife
Nothing is on sale.

>buy the sword
Nothing is on sale.

* * *

>east
You follow the east path deeper into the forest and got to the old house.

house
You are now in the old house. It looks like it has been abandoned for some time, but it is still in good repair. There is a male person standing.

It is salesman, who is standing in front of the table, on which are  several gadgets and weaponry. He stares at you intently. You can ask him about the things on the table.

You can also see a table (on which are a sword, a knife and a flaming torch) here.

(From here, you can move to the north and the west.)

>buy swor
You can't see any such thing.

>buy sword
You do not have wallet or money with you

>north
castle
The walls are made of stone, and the floors are polished marble. There are various doors and hallway leading off in different directions.

You can see a Castle Door here.

* * *

>west
garden
You are now in the garden.

Here is a huge box made of wood with a hinged lid. It is well-worn, with scratches and dents on its surface. It looks like it has been used for storing things for a long time. You can open it and see what is inside.

>open box
You open the box, revealing bag.

* * *

>open bag
You open bag, revealing a wallet.

>open wallet
You open the wallet, revealing 20 dollar bills.

>take wallet
Amazing, you have money. You can buy items in the old house.

* * *

>south
house
You are now in the old house. It looks like it has been abandoned for some time, but it is still in good repair. There is a male person standing.

It is salesman, who is standing in front of the table, on which are  several gadgets and weaponry. He stares at you intently. You can ask him about the things on the table.

You can also see a table (on which are a sword, a knife and a flaming torch) here.

>buy sword
You can buy the the sword, the flaming torch or the knife
You hand over cash, now you have 0 dollars remaining. You take the sword from the salesman.

>buy flaming torch
You can buy the the sword, the flaming torch or the knife

* * *

>east
You follow the east path deeper into the forest and got to the old house.

house
You are now in the old house. It looks like it has been abandoned for some time, but it is still in good repair. There is a male person standing.

It is salesman, who is standing in front of the table, on which are  several gadgets and weaponry. He stares at you intently. You can ask him about the things on the table.

You can also see a table (on which are a sword, a knife and a flaming torch) here.

(From here, you can move to the north and the west.)

>buy sword
You do not have wallet or money with you

>east
You can't go that way.

>north
castle
The walls are made of stone, and the floors are polished marble. There are various doors and hallway leading off in different directions.

You can see a Castle Door here.

>east
I can not see in dark. The player can not enter garage

>west
garden
You are now in the garden.

Here is a huge box made of wood with a hinged lid. It is well-worn, with scratches and dents on its surface. It looks like it has been used for storing things for a long time. You can open it and see what is inside.

* * *

>south
house
You are now in the old house. It looks like it has been abandoned for some time, but it is still in good repair. There is a male person standing.

It is salesman, who is standing in front of the table, on which are  several gadgets and weaponry. He stares at you intently. You can ask him about the things on the table.

You can also see a table (on which are a sword, a knife and a flaming torch) here.

>buy sword
You can buy the the flaming torchYou hand over cash, now you have 10 dollars remaining. You take the flaming torch from the salesman.

* * *

>open bag
You open bag, revealing a wallet.

>open wallet
You open the wallet, revealing a d dollar bills.

* * *

>west
garden
You are now in the garden.

Here is a huge box made of wood with a hinged lid. It is well-worn, with scratches and dents on its surface. It looks like it has been used for storing things for a long time. You can open it and see what is inside.

>west
You can't go that way.

>open box
You open the box, revealing bag.

>open baf
You can't see any such thing.

>open bag
You open bag, revealing wallet.

* * *

>inventory
You are carrying:
  wallet (closed)

* * *

>north
castle
The walls are made of stone, and the floors are polished marble. There are various doors and hallway leading off in different directions.

You can see a Castle Door here.

>west
garden
The hudge box made of wood and has a hinged lid. It is well-worn, with scratches and dents on its surface. It looks like it has been used for storing things for a long time.

>open box
You open the box, revealing bag.

* * *

>open bag
You open bag, revealing wallet.

>open wallet
You open wallet, revealing twenty dollar bills.

>take twenty dollar bills
dollar bill: Taken.
dollar bill: Taken.
dollar bill: Taken.
dollar bill: Taken.
dollar bill: Taken.
dollar bill: Taken.
dollar bill: Taken.
dollar bill: Taken.
dollar bill: Taken.
dollar bill: Taken.
dollar bill: Taken.
dollar bill: Taken.
dollar bill: Taken.
dollar bill: Taken.
dollar bill: Taken.
dollar bill: Taken.
dollar bill: Taken.
dollar bill: Taken.
dollar bill: Taken.
dollar bill: Taken.

>east
castle
The walls are made of stone, and the floors are polished marble. There are various doors and hallway leading off in different directions.

You can see a Castle Door here.

>south
house
You are now in the old house. It looks like it has been abandoned for some time, but it is still in good repair. There is a male person standing.

It is salesman, who is standing in front of the table, staring at you intently.

You can also see a table (on which are a sword, a knife and a flaming torch) here.

>buy sword
You do not have wallet or money with you
Nothing is on sale.

* * *

>east
You follow the east path deeper into the forest and got to the old house.

house
You are now in the old house. It looks like it has been abandoned for some time, but it is still in good repair. There is a male person standing.

It is salesman, who is standing in front of the table, on which are  several gadgets and weaponry. He stares at you intently. You can ask him about the things on the table.

You can also see a table (on which are a sword, a knife and a flaming torch) here.

(From here, you can move to the north and the west.)

>buy the flaming troch
I only understood you as far as wanting to buy the flaming torch.

>buy flaming troch
I only understood you as far as wanting to buy the flaming torch.

>buy flaming torch
You do not have wallet or money with you
Nothing is on sale.

>north
castle
The walls are made of stone, and the floors are polished marble. There are various doors and hallway leading off in different directions.

You can see a Castle Door here.

* * *

>east
castle
The walls are made of stone, and the floors are polished marble. There are various doors and hallway leading off in different directions.

You can see a Castle Door here.

>east
I can not see in dark. The player can not enter garage

>west
garden
The hudge box made of wood and has a hinged lid. It is well-worn, with scratches and dents on its surface. It looks like it has been used for storing things for a long time.

>south
You can't go that way.

>east
castle
The walls are made of stone, and the floors are polished marble. There are various doors and hallway leading off in different directions.

You can see a Castle Door here.

* * *

>south
house
You are now in the old house. It looks like it has been abandoned for some time, but it is still in good repair. There is a male person standing.

It is salesman, who is standing in front of the table, staring at you intently.

You can also see a table (on which are a sword, a knife and a flaming torch) here.

>buy flaming torch
You hand over cash, now you have 10 dollars remaining. You take the flaming torch from the salesman.

Nothing is on sale.

>north
castle
The walls are made of stone, and the floors are polished marble. There are various doors and hallway leading off in different directions.

You can see a Castle Door here.

>esat
That's not a verb I recognise.

>east
garage
You can not see anything. In order to see something you must have a flaming torch.

You can see everything. Now I can search for key
You would have to get out of the garage first.

* * *

>east
You follow the east path deeper into the forest and got to the old house.

house
You are now in the old house. It looks like it has been abandoned for some time, but it is still in good repair. There is a male person standing.

It is salesman, who is standing in front of the table, on which are  several gadgets and weaponry. He stares at you intently. You can ask him about the things on the table.

You can also see a table (on which are a sword, a knife and a flaming torch) here.

(From here, you can move to the north and the west.)

>buy the knide
You can't see any such thing.

>buy the knife
You do not have wallet or money with you
I want to buy the knife

* * *

>east
You follow the east path deeper into the forest and got to the old house.

house
You are now in the old house. It looks like it has been abandoned for some time, but it is still in good repair. There is a male person standing.

It is salesman, who is standing in front of the table, on which are  several gadgets and weaponry. He stares at you intently. You can ask him about the things on the table.

You can also see a table (on which are a sword, a knife and a flaming torch) here.

(From here, you can move to the north and the west.)

>buy the knife
You do not have wallet or money with you

>buy sword
You do not have wallet or money with you
You do not have enough money to buy the sword

* * *

>buy the knife
You do not have wallet or money with you

>buy the flaming torch
You can't see any such thing.

>north
castle
The walls are made of stone, and the floors are polished marble. There are various doors and hallway leading off in different directions.

You can see a Castle Door here.

* * *

>east
castle
The walls are made of stone, and the floors are polished marble. There are various doors and hallway leading off in different directions.

You can see a Castle Door here.

>south
house
You are now in the old house. It looks like it has been abandoned for some time, but it is still in good repair. There is a male person standing.

It is salesman, who is standing with a briefcase in his hand which is filled with several gadgets and weaponry. He stares at you intently. You can ask him about the things he carries in briefcase.

>buy the knife
You can't see any such thing.

>buy the flaming torch
You can't see any such thing.

* * *

>buy the knife
You do not have wallet or money with you

>buy the knife on the table
You can't see any such thing.

>buy knife
You can't see any such thing.

>examine
(the Salesman)
You see nothing special about the Salesman.

>examine table
You can't see any such thing.

* * *

>buy the knife
You do not have wallet or money with you

>north
castle
You are now in front of castle. In order to get into the castle you need to open the Castle Door.

You can see a Castle Door here.

>north
(first opening the Castle Door)
The Castle Door is locked.
Search for the key in the garage.

>east
It is dark in here, I can not see in dark.
The player can not enter garage.
Only way to get inside is, if you have flaming torch

>west
garden
You are now in the garden.

Here is a huge box made of wood with a hinged lid. It is well-worn, with scratches and dents on its surface. It looks like it has been used for storing things for a long time. You can open it and see what is inside.

* * *

>take wallet
Amazing, you have money. You can buy items in the old house.

>east
castle
You are now in front of castle. In order to get into the castle you need to open the Castle Door.

You can see a Castle Door here.

>south
house
You are now in the old house. It looks like it has been abandoned for some time, but it is still in good repair. There is a male person standing.

It is salesman, who is standing in front of the table, on which are  several gadgets and weaponry. He stares at you intently. You can ask him about the things on the table.

You can also see a table (on which are a sword, a knife and a flaming torch) here.

>buy flaming torch
Salesman says: You can buy the the sword, the flaming torch or the knife if you have enough money
I want to buy the flaming torchYou hand over cash, now you have 10 dollars remaining.
You take the flaming torch from the salesman.

* * *

>north
castle
You are now in front of castle. In order to get into the castle you need to open the Castle Door.

You can see a Castle Door here.

>west
garden
You are now in the garden.

Here is a huge box made of wood with a hinged lid. It is well-worn, with scratches and dents on its surface. It looks like it has been used for storing things for a long time. You can open it and see what is inside.

>open bag
You can't see any such thing.

>open box
You open the box, revealing bag.

>open box
That's already open.

>open bag
You open bag, revealing a wallet.

* * *

>south
house
You are now in the old house. It looks like it has been abandoned for some time, but it is still in good repair. There is a male person standing.

It is salesman, who is standing in front of the table, on which are  several gadgets and weaponry. He stares at you intently. You can ask him about the things on the table.

You can also see a table (on which are a sword, a knife and a flaming torch) here.

>buy the flaming torch
Salesman says: You can buy the the sword, the flaming torch or the knife if you have enough money

I want to buy the flaming torch
You hand over cash, now you have 10 dollars remaining.
You take the flaming torch from the salesman.

* * *

>east
You follow the east path deeper into the forest and got to the old house.

house
You are now in the old house. It looks like it has been abandoned for some time, but it is still in good repair. There is a male person standing.

It is salesman, who is standing in front of the table, on which are  several gadgets and weaponry. He stares at you intently. You can ask him about the things on the table.

You can also see a table (on which are a sword, a knife and a flaming torch) here.

(From here, you can move to the north and the west.)

>buy the sword
You do not have wallet or money with you
Nothing is on sale.

>ask salseman about sword
You can't see any such thing.

>ask salseman about the sword
You can't see any such thing.

>ask salesman about the sword
It costs 20 coins

>north
castle
The walls are made of stone, and the floors are polished marble. There are various doors and hallway leading off in different directions.

You can see a Castle Door here.

>north
(first opening the Castle Door)
It seems to be locked.

>east
I can not see in dark. The player can not enter garage

>west
garden
You can see thhe hudge box made of wood with a hinged lid. It is well-worn, with scratches and dents on its surface. It looks like it has been used for storing things for a long time.

>west
You can't go that way.

* * *

>east
castle
The walls are made of stone, and the floors are polished marble. There are various doors and hallway leading off in different directions.

You can see a Castle Door here.

>south
house
You are now in the old house. It looks like it has been abandoned for some time, but it is still in good repair. There is a male person standing.

It is salesman, who is standing in with a briefcase filled with several gadgets and weaponry, staring at you intently.

>buy the flaming torch
You hand over cash, now you have 10 dollars remaining. You take the flaming torch from the salesman.

Nothing is on sale.

>inventory
You are carrying:
  a flaming torch (providing light)
  wallet (closed)

>north
castle
The walls are made of stone, and the floors are polished marble. There are various doors and hallway leading off in different directions.

You can see a Castle Door here.

>east
garage
It is dark in here. In order to see something you must have a flaming torch.

You can see a table here.

You can see everything. Now you can search for key
You would have to get out of the garage first.

>examine table
It is made of sturdy oak and has a smooth, polished finish. There are various weaponry and gadgets on the desk.

* * *

>east
You follow the east path deeper into the forest and got to the old house.

house
You are now in the old house. It looks like it has been abandoned for some time, but it is still in good repair. There is a male person standing.

It is salesman, who is standing in front of the table, on which are  several gadgets and weaponry. He stares at you intently. You can ask him about the things on the table.

You can also see a table (on which are a sword, a knife and a flaming torch) here.

(From here, you can move to the north and the west.)

>east
You follow the east path deeper into the forest.

>east path
You follow the east path deeper into the forest.

You can't go that way.

>west
Which do you mean, the west or the West Path?

>west path
You follow the west path out of the forest and into the house.

house
You would have to get out of the house first.

>west
Which do you mean, the west or the West Path?

>west
Which do you mean, the west or the West Path?

>east
Which do you mean, the east or the East Path?

* * *

>east
You follow the east path deeper into the forest.

>west
You follow the west path out of the forest and into the house.

house
It looks like it has been abandoned for some time, but it is still in good repair. There is a fireplace in one corner and a few old pieces of furniture scattered around the room.

A salesman is standing in front of the table, staring at you intently.

You would have to get out of the house first.

>examine table
You can't see any such thing.

* * *

>east
You follow the east path deeper into the forest and got to the old house.

house
You are now in the old house. It looks like it has been abandoned for some time, but it is still in good repair. There is a male person standing.

It is salesman, who is standing in front of the table, on which are  several gadgets and weaponry. He stares at you intently. You can ask him about the things on the table.

You can also see a table (on which are a sword, a knife and a flaming torch) here.

(From here, you can move to the north and the west.)

>east path
You follow the east path deeper into the forest.

You can't go that way.

* * *

>west
Which do you mean, the west or the West Path?

>west path
You follow the west path out of the forest and into the house.

house
It looks like it has been abandoned for some time, but it is still in good repair. There is a fireplace in one corner and a few old pieces of furniture scattered around the room.

A salesman is sitting in one of the chairs, staring at you intently. He is holding a small case filled with various trinkets and gadgets.

You would have to get out of the house first.

>north
castle
The walls are made of stone, and the floors are polished marble. There are various doors and hallway leading off in different directions.

>north
hallway
You can see Door 1 and Door 2 here.

>door 1
You open Door 1.

Kitchen

>east
Which do you mean, the east or the East Path?

>east
Which do you mean, the east or the East Path?

>west
That's not a verb I recognise.

>outside
hallway
You can see Door 1 and Door 2 here.

>north
You can't go that way.

>south
castle
The walls are made of stone, and the floors are polished marble. There are various doors and hallway leading off in different directions.

>west
Which do you mean, the west or the West Path?

>east
That's not a verb I recognise.

>the west
That's not a verb I recognise.

>the east
That's not a verb I recognise.

>south
house
It looks like it has been abandoned for some time, but it is still in good repair. There is a fireplace in one corner and a few old pieces of furniture scattered around the room.

A salesman is sitting in one of the chairs, staring at you intently. He is holding a small case filled with various trinkets and gadgets.

>east
Which do you mean, the east or the East Path?

>the east path
That's not a verb I recognise.

>east path
You cannot go east from here.

You can't go that way.

>west path
You cannot go west from here.

You can't go that way.

>north
castle
The walls are made of stone, and the floors are polished marble. There are various doors and hallway leading off in different directions.

>west
Which do you mean, the west or the West Path?

>go west
Which do you mean, the west or the West Path?

>the west
Which do you mean, the west or the West Path?

* * *

>east
You follow the east path deeper into the forest and got to the old house.

house
You are now in the old house. It looks like it has been abandoned for some time, but it is still in good repair. There is a male person standing.

It is salesman, who is standing in front of the table, on which are  several gadgets and weaponry. He stares at you intently. You can ask him about the things on the table.

You can also see a table (on which are a sword, a knife and a flaming torch) here.

(From here, you can move to the north and the west.)

>how much the sword costs
That's not a verb I recognise.

>how much for th sword
That's not a verb I recognise.

>how much for the sword
That's not a verb I recognise.

>ask salesman how much the sword costs
I didn't understand that sentence.

* * *

>east
You follow the east path deeper into the forest and got to the old house.

house
You are now in the old house. It looks like it has been abandoned for some time, but it is still in good repair. There is a male person standing.

It is salesman, who is standing in front of the table, on which are  several gadgets and weaponry. He stares at you intently. You can ask him about the things on the table.

You can also see a table (on which are a sword, a knife and a flaming torch) here.

(From here, you can move to the north and the west.)

>noeth
That's not a verb I recognise.

>north
castle
You are now in front of castle. In order to get into the castle you need to open the Castle Door.

You can see a Castle Door here.

(From here, you can move to the north, the south, the east, the west and the inside.)

>west
garden
You are now in the garden.

Here is a huge box made of wood with a hinged lid. It is well-worn, with scratches and dents on its surface. It looks like it has been used for storing things for a long time. You can open it and see what is inside.

(From here, you can move to the east.)

>open bag
You can't see any such thing.

* * *

>buy flaming torch
Salesman says: You can buy the the sword, the flaming torch or the knife if you have enough money

I want to buy the flaming torch

You hand over cash, now you have 10 dollars remaining.
You take the flaming torch from the salesman.

>north
castle
You are now in front of castle. In order to get into the castle you need to open the Castle Door.

You can see a Castle Door here.

(From here, you can move to the north, the south, the east, the west and the inside.)

* * *

>east
You can see everything. Now you can search for key
garage
You are in the garage. It is a large, cluttered space with a concrete floor and fluorescent lighting.

Here is also the smart fox which is a small, animal with bright, alert eyes, and a bushy tail. It looks sly and cunning, with a sharp, curious gaze that seems to suggest that it is always thinking.

You can also see a cabinet and a rug here.

(From here, you can move to the west.)

>look under rug
You saw a nickel key under the rug. Keep the key

>west
castle
You are now in front of castle. In order to get into the castle you need to open the Castle Door.

You can see a Castle Door here.

(From here, you can move to the north, the south, the east, the west and the inside.)

* * *

>a window
The fox says: You are right, here is cure

>drink cure
You slurp down the cure. Refreshing!

A starvation occurs in three minutes from now

>west
castle
You are now in front of castle. In order to get into the castle you need to open the Castle Door.

You can see a Castle Door here.

(From here, you can move to the north, the south, the east, the west and the inside.)

* * *

>north
(first opening the Castle Door)
hallway
You can see a Castle Door, Door 1 and Door 2 here.

(From here, you can move to the south, the inside and the outside.)

>door 2
You are in Princesses room, but you can see enormous dragon that is very hungry.

    *** Dragon ate you, because you did not bring him any food. GAME OVER ***

Would you like to RESTART, RESTORE a saved game, QUIT or UNDO the last command?

* * *

>undo
hallway
[Previous turn undone.]

>door 1
kitchen
You are in the castle's kitchen. It is a large, well-equipped space with a fireplace, a fridge, and a table in the center. The smell of cooking food fills the air.

The old fridge is a large, white appliance with a dented surface and a handle on the door. It has three cakes inside.

You can also see a wallet (closed) here.

(From here, you can move to the outside.)

* * *

>out
hallway
You can see a Castle Door, Door 1 and Door 2 here.

(From here, you can move to the south, the inside and the outside.)

    *** You have starved ***

Would you like to RESTART, RESTORE a saved game, QUIT or UNDO the last command?

* * *

>east
You follow the east path deeper into the forest and got to the old house.

house
You are now in the old house. It looks like it has been abandoned for some time, but it is still in good repair. There is a male person standing.

It is salesman, who is standing in front of the table, on which are  several gadgets and weaponry. He stares at you intently. You can ask him about the things on the table.

You can also see a table (on which are a sword, a knife and a flaming torch) here.

(From here, you can move to the north and the west.)

>north
castle
You are now in front of castle. In order to get into the castle you need to open the Castle Door.

You can see a Castle Door here.

(From here, you can move to the north, the south, the east, the west and the inside.)

I beg your pardon?

>west
garden
You are now in the garden.

Here is a huge box made of wood with a hinged lid. It is well-worn, with scratches and dents on its surface. It looks like it has been used for storing things for a long time. You can open it and see what is inside.

* * *

>south
house
You are now in the old house. It looks like it has been abandoned for some time, but it is still in good repair. There is a male person standing.

It is salesman, who is standing in front of the table, on which are  several gadgets and weaponry. He stares at you intently. You can ask him about the things on the table.

You can also see a table (on which are a sword, a knife and a flaming torch) here.

>buy flaming torch
You can buy the the sword, the flaming torch or the knife if you have enough money
You hand over cash, now you have 10 dollars remaining. You take the flaming torch from the salesman.

>north
castle
You are now in front of castle. In order to get into the castle you need to open the Castle Door.

You can see a Castle Door here.

>east
You can see everything. Now you can search for key
garage
You are in the garage. It is a large, cluttered space with a concrete floor and fluorescent lighting. There is a cabinet along one wall, with a variety of tools and a vase with roses on it.

The smart fox is a small, animal with bright, alert eyes, and a bushy tail. It looks sly and cunning, with a sharp, curious gaze that seems to suggest that it is always thinking.

You can also see a cabinet (on which is a vase (in which are a nickel key and a roses)) here.

>take nickel key
Taken.

>west
castle
You are now in front of castle. In order to get into the castle you need to open the Castle Door.

You can see a Castle Door here.

>north
(first opening the Castle Door)
hallway
You can see a Castle Door, Door 1 and Door 2 here.

>door 2
You open Door 2.

Princesses Room
You entered her room, but there is enormous dragon that is very hungry. Give him poisonus cake that will kill it and save princess

The dragon is a massive, fearsome beast. It has wings that stretch out wide, and its eyes are glowing, fiery orbs. It looks like it is full of hatred and malice, and it seems to relish the thought of causing destruction and chaos.

>feed the dragon with cheesecake
You feed the dragon with cheesecake. It is munching it down, grunting happily.

* * *

>north
castle
You are now in front of castle. In order to get into the castle you need to open the Castle Door.

You can see a Castle Door here.

(From here, you can move to the north, the south, the east, the west and the inside.)

>east
The player can not enter garage.
Only way to get inside is, if you have flaming torch
Darkness
It is pitch dark, and you can't see a thing.

(From here, you can move to the west.)

>south
house
You are now in the old house. It looks like it has been abandoned for some time, but it is still in good repair. There is a male person standing.

It is salesman, who is standing with a briefcase in his hand which is filled with several gadgets and weaponry. He stares at you intently.

>west
You can't go that way.

>north
castle
The walls are made of stone, and the floors are polished marble. There are various doors and hallway leading off in different directions.

You can see a Castle Door here.

>west
garden
You can see thhe hudge box made of wood with a hinged lid. It is well-worn, with scratches and dents on its surface. It looks like it has been used for storing things for a long time.

>open box
You open the box, revealing bag.

* * *

>take wallet
Amazing, you have money. You can buy items in the old house.

>west
You can't go that way.

>east
castle
The walls are made of stone, and the floors are polished marble. There are various doors and hallway leading off in different directions.

You can see a Castle Door here.

>south
house
You are now in the old house. It looks like it has been abandoned for some time, but it is still in good repair. There is a male person standing.

It is salesman, who is standing with a briefcase in his hand which is filled with several gadgets and weaponry. He stares at you intently.

>buy flaming torch
You hand over cash, now you have 10 dollars remaining. You take the thing from the salesman.

Nothing is on sale.

>north
castle
The walls are made of stone, and the floors are polished marble. There are various doors and hallway leading off in different directions.

You can see a Castle Door here.

>east
garage
It is dark in here. In order to see something you must have a flaming torch.

The smart fox is a small, animal with bright, alert eyes, and a bushy tail. It looks sly and cunning, with a sharp, curious gaze that seems to suggest that it is always thinking.

You can also see a table (on which is a vase (in which are a nickel key and Rose)) here.

You can see everything. Now you can search for key
You would have to get out of the garage first.

* * *

>west
castle
You are now in front of castle. In order to get into the castle you need to open the Castle Door.

You can see a Castle Door here.

(From here, you can move to the north, the south, the east, the west and the inside.)

>open box
You open the box, revealing bag.

* * *

>open bag
You open bag, revealing a wallet.

>open wallet
You open wallet, revealing twenty dollar bills.

>take wallet
Amazing, you have money. You can buy items in the old house.

* * *

>east
You can see everything. Now you can search for key
garage
You are in the garage. It is a large, cluttered space with a concrete floor and fluorescent lighting. There is a cabinet along one wall, with a variety of tools and a vase with roses on it.

The smart fox is a small, animal with bright, alert eyes, and a bushy tail. It looks sly and cunning, with a sharp, curious gaze that seems to suggest that it is always thinking.

You can also see a cabinet (on which is a vase (in which are a nickel key and a roses)) here.

>examine vase
In the vase are a nickel key and a roses.

>take nickel key
Taken.

* * *

>north
(first opening the Castle Door)
hallway
You can see a Castle Door, Door 1 and Door 2 here.

>door 1
You open Door 1.

kitchen
You are in the castle's kitchen. It is a large, well-equipped space with a fireplace, a fridge, and a table in the center. The smell of cooking food fills the air.

The old fridge is a large, white appliance with a dented surface and a handle on the door. It has three cakes inside.

>eat dobosica
You are poisoned  and have to find a cure if you want to live. The fox has the cure.

(first taking the dobosica)
You eat the dobosica. Not bad.

>out
hallway
You can see a Castle Door, Door 1 and Door 2 here.

>out
castle
You are now in front of castle. In order to get into the castle you need to open the Castle Door.

You can see a Castle Door here.

>east
You can see everything. Now you can search for key
garage
You are in the garage. It is a large, cluttered space with a concrete floor and fluorescent lighting. There is a cabinet along one wall, with a variety of tools and a vase with roses on it.

The smart fox is a small, animal with bright, alert eyes, and a bushy tail. It looks sly and cunning, with a sharp, curious gaze that seems to suggest that it is always thinking.

You can also see a cabinet (on which is a vase (in which is a roses)) here.

>examine fox
Hello smart fox, I am poisoned and need the cure. Can you help me?. Fox says: Yes, but you need to answer this riddle. What invention lets you look right through a wall? 
You see nothing special about the fox.

Enter the answer:

>hah
That's not a verb I recognise.

Enter the answer:

>ahaha
That's not a verb I recognise.

Enter the answer:

>a window
The fox says: You are right, here is cure

* * *

>east
You can see everything. Now you can search for key
garage
You are in the garage. It is a large, cluttered space with a concrete floor and fluorescent lighting. There is a cabinet along one wall, with a variety of tools and a vase with roses on it.

The smart fox is a small, animal with bright, alert eyes, and a bushy tail. It looks sly and cunning, with a sharp, curious gaze that seems to suggest that it is always thinking.

You can also see a cabinet (on which is a vase (in which is a roses)) here.

>examine foy
You can't see any such thing.

>examine fox
Hello smart fox, I am poisoned and need the cure. Can you help me?. Fox says: Yes, but you need to answer this riddle. What invention lets you look right through a wall? 
You see nothing special about the fox.

Enter the answer:

>lal
That's not a verb I recognise.

Enter the answer:

>kaka
That's not a verb I recognise.

Enter the answer:

>a window
The fox says: You are right, here is cure

>drink
What do you want to drink?

>cure
*** Fox says: That is wrong answer, no cure for you.
Poison is all over your body, you died: GAME OVER ***

Would you like to RESTART, RESTORE a saved game, QUIT or UNDO the last command?

* * *

>east
You can see everything. Now you can search for key
garage
You are in the garage. It is a large, cluttered space with a concrete floor and fluorescent lighting. There is a cabinet along one wall, with a variety of tools and a vase with roses on it.

The smart fox is a small, animal with bright, alert eyes, and a bushy tail. It looks sly and cunning, with a sharp, curious gaze that seems to suggest that it is always thinking.

You can also see a cabinet (on which is a vase (in which are a nickel key and a roses)) here.

>remove the Rose from the vase
You picked roses from the vase and can see the nickel key. Keep the key

>west
castle
The walls are made of stone, and the floors are polished marble. There are various doors and hallway leading off in different directions.

You can see a Castle Door here.

>north
(first opening the Castle Door)
It seems to be locked.

* * *

>take nickel key
Taken.

>north
You can't go that way.

>west
castle
You are now in front of castle. In order to get into the castle you need to open the Castle Door.

You can see a Castle Door here.

* * *

>door 1
You open Door 1.

kitchen
You are in the castle's kitchen. It is a large, well-equipped space with a fireplace, a fridge, and a table in the center. The smell of cooking food fills the air.

The old fridge is a large, white appliance with a dented surface and a handle on the door. It has three cakes inside.

>open fridge
I am very hungry. I want to eat dobosica

* * *

>east
You can see everything. Now you can search for key
garage
You are in the garage. It is a large, cluttered space with a concrete floor and fluorescent lighting. There is a cabinet along one wall, with a variety of tools and a vase with roses on it.

The smart fox is a small, animal with bright, alert eyes, and a bushy tail. It looks sly and cunning, with a sharp, curious gaze that seems to suggest that it is always thinking.

You can also see a cabinet (on which is a vase (in which is a roses)) here.

>examine fox
Hello smart fox, I am poisoned and need the cure. Can you help me?. Fox says: Yes, but you need to answer this riddle. What invention lets you look right through a wall? 
Enter the answer:

>haha
The fox says: That's wrong, can't give you cure

>examine fox
Hello smart fox, I am poisoned and need the cure. Can you help me?. Fox says: Yes, but you need to answer this riddle. What invention lets you look right through a wall? 
Enter the answer:

>a window
The fox says: You are right, here is cure

>inventory
You are carrying:
  a cure
  a nickel key
  a flaming torch (providing light)
  a wallet (closed)

* * *

>open box
You open the box, revealing bag.

>open bah
You can't see any such thing.

>open bag
You open bag, revealing wallet.

* * *

>buy sword
You can buy the the sword, the flaming torch or the knife
You hand over cash, now you have 0 dollars remaining. You take the sword from the salesman.

>buy sword
You hand over cash, now you have 0 dollars remaining. You take the sword from the salesman.

* * *

>take wallet
Amazing, you have money. You can buy items in the old house.

>north
You can't go that way.

>east
castle
You are now in front of castle. In order to get into the castle you need to open the Castle Door.

You can see a Castle Door here.

(From here, you can move to the north, the south, the east, the west and the inside.)

* * *

>south
house
You are now in the old house. It looks like it has been abandoned for some time, but it is still in good repair. There is a male person standing.

It is salesman, who is standing in front of the table, on which are  several gadgets and weaponry. He stares at you intently. You can ask him about the things on the table.

You can also see a table (on which are a sword, a knife and a flaming torch) here.

(From here, you can move to the north and the west.)

>buy flaming torch
Salesman says: You can buy the the sword, the flaming torch or the knife if you have enough money

Jack: I want to buy the flaming torch

You hand over cash, now you have 10 dollars remaining.
You take the flaming torch from the salesman.

>open wallet
That's already open.

>see wallet
That's not a verb I recognise.

>examine wallet
In the wallet is 20 dollar bills.

>north
castle
You are now in front of castle. In order to get into the castle you need to open the Castle Door.

You can see a Castle Door here.

(From here, you can move to the north, the south, the east, the west and the inside.)

* * *

>east
You can see everything. Now you can search for key
garage
You are in the garage. It is a large, cluttered space with a concrete floor and fluorescent lighting.

Here is also the smart fox which is a small, animal with bright, alert eyes, and a bushy tail. It looks sly and cunning, with a sharp, curious gaze that seems to suggest that it is always thinking.

You can also see a cabinet and a rug here.

(From here, you can move to the west.)

>look cabinet
It is made of sturdy oak and has a smooth, polished finish.

 You can notice that the drawer is part of the cabinet

>look drawer
In the drawer is a paper.

>read paper
In the paper is a message.

* * *

>drop wallet
Dropped.

>eat dobosica
(first taking the dobosica)
I am full now.

*** Run-time problem P10: Since the dobosica is not allowed the property "aggravate period", it is against the rules to try to use it.

You are poisoned and have to find a cure if you want to live. The fox has the cure.

Eaten poison occurs in 5 minutes from now, you better find cure

* * *

>buy flaming torch
Salesman says: You can buy the the sword, the flaming torch or the knife if you have enough money

Jack: I want to buy the flaming torch

You hand over cash, now you have 10 dollars remaining.
You take the flaming torch from the salesman.

>north
castle
You are now in front of castle. In order to get into the castle you need to open the Castle Door.

You can see a Castle Door here.

(From here, you can move to the north, the south, the east, the west and the inside.)

* * *

>open drawer
That's already open.

>examine drawer
In the drawer is a paper.

>look paper
You see nothing special about the paper.

>examine paper
You see nothing special about the paper.

>examine fox
Fox says: Do you need something?
You see nothing special about the fox.

>look under rug
You saw a nickel key under the rug. Keep the key

* * *

>door 1
You open Door 1.

kitchen
You are in the castle's kitchen. It is a large, well-equipped space with a fireplace, a fridge, and a table in the center. The smell of cooking food fills the air.

The old fridge is a large, white appliance with a dented surface and a handle on the door. It has three cakes inside.

(From here, you can move to the outside.)

>look in fridge
You can't see inside, since the fridge is closed.

>open fridge
I am very hungry. I want to eat dobosica

>look in fridge
In the fridge are a cheesecake, a dobosica and a chocolate cake.

>eat dobosica
(first taking the dobosica)
You're carrying too many things already.

* * *

>drop wallet
Dropped.

>eat dobosica
(first taking the dobosica)
You are poisoned and have to find a cure if you want to live. The fox has the cure.

>out
hallway
You can see a Castle Door, Door 1 and Door 2 here.

(From here, you can move to the south, the inside and the outside.)

* * *

>east
You can see everything. Now you can search for key
garage
You are in the garage. It is a large, cluttered space with a concrete floor and fluorescent lighting.

Here is also the smart fox which is a small, animal with bright, alert eyes, and a bushy tail. It looks sly and cunning, with a sharp, curious gaze that seems to suggest that it is always thinking.

You can also see a cabinet and a rug here.

(From here, you can move to the west.)

>examine fox
Hello smart fox, I am poisoned and need the cure. Can you help me?.
Fox says:  Yes, but you need to answer this riddle. 
What invention lets you look right through a wall? 
You see nothing special about the fox.

Enter the answer:

>a window
The fox says: You are right, here is cure

* * *

>drink cure
You slurp down the cure. Refreshing!

>examine fox
Hello smart fox, I am poisoned and need the cure. Can you help me?.
Fox says:  Yes, but you need to answer this riddle. 
What invention lets you look right through a wall? 
You see nothing special about the fox.

Enter the answer:

>jaj
The fox says: That's wrong, can't give you cure

>inventory
You are carrying:
  a nickel key
  a flaming torch (providing light)

>west
castle
You are now in front of castle. In order to get into the castle you need to open the Castle Door.

You can see a Castle Door here.

(From here, you can move to the north, the south, the east, the west and the inside.)

* * *

>north
(first opening the Castle Door)
hallway
You can see a Castle Door, Door 1 and Door 2 here.

(From here, you can move to the south, the inside and the outside.)

>door 1
kitchen
You are in the castle's kitchen. It is a large, well-equipped space with a fireplace, a fridge, and a table in the center. The smell of cooking food fills the air.

The old fridge is a large, white appliance with a dented surface and a handle on the door. It has three cakes inside.

You can also see a wallet (closed) here.

(From here, you can move to the outside.)

>open fridge
That's already open.

>look in fridge
In the fridge are a cheesecake and a chocolate cake.

>out
hallway
You can see a Castle Door, Door 1 and Door 2 here.

(From here, you can move to the south, the inside and the outside.)

* * *

>undo
hallway
[Previous turn undone.]

>out
castle
You are now in front of castle. In order to get into the castle you need to open the Castle Door.

You can see a Castle Door here.

(From here, you can move to the north, the south, the east, the west and the inside.)

>door 1
That's not a verb I recognise.

>north
(first opening the Castle Door)
hallway
You can see a Castle Door, Door 1 and Door 2 here.

(From here, you can move to the south, the inside and the outside.)

* * *

>door 1
kitchen
You are in the castle's kitchen. It is a large, well-equipped space with a fireplace, a fridge, and a table in the center. The smell of cooking food fills the air.

The old fridge is a large, white appliance with a dented surface and a handle on the door. It has three cakes inside.

You can also see a wallet (closed) here.

(From here, you can move to the outside.)

>take chocolate cake
Taken.

* * *

>east
You can see everything. Now you can search for key
garage
You are in the garage. It is a large, cluttered space with a concrete floor and fluorescent lighting.

Here is also the smart fox which is a small, animal with bright, alert eyes, and a bushy tail. It looks sly and cunning, with a sharp, curious gaze that seems to suggest that it is always thinking.

You can also see a cabinet and a rug here.

(From here, you can move to the west.)

>examine fox
Fox says: Do you need something?
You see nothing special about the fox.

>look cabinet
It is made of sturdy oak and has a smooth, polished finish.

>look under rug
You picked roses from the vase and can see the nickel key. Keep the key

>west
castle
You are now in front of castle. In order to get into the castle you need to open the Castle Door.

You can see a Castle Door here.

(From here, you can move to the north, the south, the east, the west and the inside.)

* * *

>undo
hallway
[Previous turn undone.]

>door 1
You open Door 1.

kitchen
You are in the castle's kitchen. It is a large, well-equipped space with a fireplace, a fridge, and a table in the center. The smell of cooking food fills the air.

The old fridge is a large, white appliance with a dented surface and a handle on the door. It has three cakes inside.

(From here, you can move to the outside.)

>open firdge
You can't see any such thing.

>open fridge
I am very hungry. I want to eat dobosica

>eat dobosica
You are poisoned  and have to find a cure if you want to live. The fox has the cure.

(first taking the dobosica)
You're carrying too many things already.

>inventory
You are carrying:
  a nickel key
  a flaming torch (providing light)
  a wallet (closed)

>drop wallet
Dropped.

>inventory
You are carrying:
  a nickel key
  a flaming torch (providing light)

>eat dobosica
You are poisoned  and have to find a cure if you want to live. The fox has the cure.

(first taking the dobosica)
You eat the dobosica. Not bad.

* * *

>look under rug
You saw a nickel key under the rug. Keep the key

>out
But you aren't in anything at the moment.

>west
castle
You are now in front of castle. In order to get into the castle you need to open the Castle Door.

You can see a Castle Door here.

(From here, you can move to the north, the south, the east, the west and the inside.)

>inside
hallway
You can see a Castle Door, Door 1 and Door 2 here.

(From here, you can move to the south, the inside and the outside.)

>door 1
You open Door 1.

kitchen
You are in the castle's kitchen. It is a large, well-equipped space with a fireplace, a fridge, and a table in the center. The smell of cooking food fills the air.

The old fridge is a large, white appliance with a dented surface and a handle on the door. It has three cakes inside.

(From here, you can move to the outside.)

>drop wallet
Dropped.

>take cheesecake
You can't see any such thing.

>open fridge
I am very hungry. I want to eat dobosica

>take cheesecake
*** Run-time problem P10: Since the chocolate cake is not allowed the property "poisoned", it is against the rules to try to use it.

* * *

>north
castle
You are now in front of castle. In order to get into the castle you need to open the Castle Door.

You can see a Castle Door here.

(From here, you can move to the north, the south, the east, the west and the inside.)

>insdie
That's not a verb I recognise.

>inside
The Castle Door is locked.
Search for the key in the garage.

>east
It is dark in here, I can not see in dark.
The player can not enter garage.
Only way to get inside is, if you have flaming torch

>west
garden
You are now in the garden.

Here is a huge box made of wood with a hinged lid. It is well-worn, with scratches and dents on its surface. It looks like it has been used for storing things for a long time. You can open it and see what is inside.

(From here, you can move to the east.)

* * *

>inside
The Castle Door is locked.
Search for the key in the garage.

>insdie
That's not a verb I recognise.

>inside
You'll need to be more specific. There are two of doors here.

>south
(first opening the Castle Door)
The Castle Door is locked.
Search for the key in the garage.

>outside
castle
You are now in front of castle. In order to get into the castle you need to open the Castle Door.

You can see a Castle Door here.

(From here, you can move to the north, the south, the east, the west and the inside.)

* * *

>north
castle
You are now in front of castle. In order to get into the castle you need to open the Castle Door.

You can see a Castle Door here.

(From here, you can move to the north, the south, the east, the west and the inside.)

>north
(first opening the Castle Door)
The Castle Door is still locked
It seems to be locked.

* * *

>north
castle
You are now in front of castle. In order to get into the castle you need to open the Castle Door.

You can see a Castle Door here.

(From here, you can move to the north, the south, the east, the west and the inside.)

>open castle door
The Castle Door is locked.
Search for the key in the garage.

>east
It is dark in here, I can not see in dark.
The player can not enter garage.
Only way to get inside is if you have falming torch

>west
garden
You are now in the garden.

Here is a huge box made of wood with a hinged lid. It is well-worn, with scratches and dents on its surface. It looks like it has been used for storing things for a long time. You can open it and see what is inside.

* * *

>open castle door
The Castle Door is locked.
Search for the key in the garage.

>inside
The Castle Door is locked.
Search for the key in the garage.

>east
The player can not enter garage.
Only way to get inside is, if you have flaming torch
Darkness
It is pitch dark, and you can't see a thing.

(From here, you can move to the west.)

* * *

>take wallet
Amazing, you have money. You can buy items in the old house.

>examine wallet
You see nothing special about the wallet.

>open wallet
You open the wallet, revealing 20 dollar bills.

* * *

>open wallet
That's already open.

>look in wallet
In the wallet is 20 dollar bills.

>north
castle
You are now in front of castle. In order to get into the castle you need to open the Castle Door.

You can see a Castle Door here.

(From here, you can move to the north, the south, the east, the west and the inside.)

>drop wallet
Dropped.

>east
You can see everything. Now you can search for key
garage
You are in the garage. It is a large, cluttered space with a concrete floor and fluorescent lighting.

Here is also the smart fox which is a small, animal with bright, alert eyes, and a bushy tail. It looks sly and cunning, with a sharp, curious gaze that seems to suggest that it is always thinking.

You can also see a cabinet and a rug here.

(From here, you can move to the west.)

* * *

>examine fox
Fox says: Do you need something?
You see nothing special about the fox.

>look in cabinet
You find nothing of interest.

>examine cabinet
It is made of sturdy oak and has a smooth, polished finish.

 You can notice that the drawer is part of the cabinet

>open drawer
That's already open.

>look in drawer
In the drawer is a paper.

>read paper
In the paper is a message.

* * *

>look under rug
You saw a nickel key under the rug. Keep the key

>west
castle
You are now in front of castle. In order to get into the castle you need to open the Castle Door.

You can see a wallet (in which is 20 dollar bills) and a Castle Door here.

(From here, you can move to the north, the south, the east, the west and the inside.)

>north
(first opening the Castle Door)
hallway
You can see a Castle Door, Door 1 and Door 2 here.

(From here, you can move to the south, the inside and the outside.)

* * *

>undo
hallway
[Previous turn undone.]

>out
castle
You are now in front of castle. In order to get into the castle you need to open the Castle Door.

You can see a Castle Door and a wallet (in which is 20 dollar bills) here.

(From here, you can move to the north, the south, the east, the west and the inside.)

>in
hallway
You can see a Castle Door, Door 1 and Door 2 here.

(From here, you can move to the south, the inside and the outside.)

>door 1
You open Door 1.

kitchen
You are in the castle's kitchen. It is a large, well-equipped space with a fireplace, a fridge, and a table in the center. The smell of cooking food fills the air.

The old fridge is a large, white appliance with a dented surface and a handle on the door. It has three cakes inside.

(From here, you can move to the outside.)

>look in firdge
You can't see any such thing.

>look in fridge
You can't see inside, since the fridge is closed.

* * *

>open fridge
I am very hungry. I want to eat dobosica

>eat dobosica
(first taking the dobosica)
I am full now.

You are poisoned and have to find a cure if you want to live. The fox has the cure.

* * *

>out
hallway
You can see a Castle Door, Door 1 and Door 2 here.

(From here, you can move to the south, the inside and the outside.)

>out
castle
You are now in front of castle. In order to get into the castle you need to open the Castle Door.

You can see a Castle Door and a wallet (in which is 20 dollar bills) here.

(From here, you can move to the north, the south, the east, the west and the inside.)

>east
You can see everything. Now you can search for key
garage
You are in the garage. It is a large, cluttered space with a concrete floor and fluorescent lighting.

Here is also the smart fox which is a small, animal with bright, alert eyes, and a bushy tail. It looks sly and cunning, with a sharp, curious gaze that seems to suggest that it is always thinking.

You can also see a cabinet and a rug here.

(From here, you can move to the west.)

>west
castle
You are now in front of castle. In order to get into the castle you need to open the Castle Door.

You can see a Castle Door and a wallet (in which is 20 dollar bills) here.

(From here, you can move to the north, the south, the east, the west and the inside.)

Eaten poison occurs in 4 minutes from now, you better find cure

>east
You can see everything. Now you can search for key
garage
You are in the garage. It is a large, cluttered space with a concrete floor and fluorescent lighting.

Here is also the smart fox which is a small, animal with bright, alert eyes, and a bushy tail. It looks sly and cunning, with a sharp, curious gaze that seems to suggest that it is always thinking.

You can also see a cabinet and a rug here.

(From here, you can move to the west.)

* * *

>examine fox
Hello smart fox, I am poisoned and need the cure. Can you help me?.
Fox says:  Yes, but you need to answer this riddle. 
What invention lets you look right through a wall? 
Enter the answer:

>djd
The fox says: That's wrong, can't give you cure

>examine fox
Hello smart fox, I am poisoned and need the cure. Can you help me?.
Fox says:  Yes, but you need to answer this riddle. 
What invention lets you look right through a wall? 
Enter the answer:

* * *

>drink cure
You slurp down the cure. Refreshing!

>east
You can't go that way.

>west
castle
You are now in front of castle. In order to get into the castle you need to open the Castle Door.

You can see a Castle Door and a wallet (in which is 20 dollar bills) here.

(From here, you can move to the north, the south, the east, the west and the inside.)

>north
(first opening the Castle Door)
hallway
You can see a Castle Door, Door 1 and Door 2 here.

(From here, you can move to the south, the inside and the outside.)

>dor 1
That's not a verb I recognise.

>door 1
kitchen
You are in the castle's kitchen. It is a large, well-equipped space with a fireplace, a fridge, and a table in the center. The smell of cooking food fills the air.

The old fridge is a large, white appliance with a dented surface and a handle on the door. It has three cakes inside.

(From here, you can move to the outside.)

>take chocolate cake
Taken.

* * *

>out
hallway
You can see a Castle Door, Door 1 and Door 2 here.

(From here, you can move to the south, the inside and the outside.)

>door 2
You are in Princesses room, but you can see enormous dragon that is very hungry.

You open Door 2.

Princesses Room
You entered her room, but there is enormous dragon that is very hungry. Feed it with a poisonus cake and save princess

The dragon is a massive, fearsome beast. It has wings that stretch out wide, and its eyes are glowing, fiery orbs. It looks like it is full of hatred and malice, and it seems to relish the thought of causing destruction and chaos.

The princess is standing in the back of the room, she is looking scared.

(From here, you can move to the outside.)

>feed dragon with cake
*** Dragon ate the cake you brought him, but he is still hungry, so you are his food. GAME OVER ***

Would you like to RESTART, RESTORE a saved game, QUIT or UNDO the last command?

>undo
Princesses Room
[Previous turn undone.]

>out
hallway
You can see a Castle Door, Door 1 and Door 2 here.

(From here, you can move to the south, the inside and the outside.)

>door 1
kitchen
You are in the castle's kitchen. It is a large, well-equipped space with a fireplace, a fridge, and a table in the center. The smell of cooking food fills the air.

The old fridge is a large, white appliance with a dented surface and a handle on the door. It has three cakes inside.

(From here, you can move to the outside.)

>drop chocolate cake
Dropped.

* * *

>out
hallway
You can see a Castle Door, Door 1 and Door 2 here.

(From here, you can move to the south, the inside and the outside.)

>door 2
Princesses Room
You entered her room, but there is enormous dragon that is very hungry. Feed it with a poisonus cake and save princess

The dragon is a massive, fearsome beast. It has wings that stretch out wide, and its eyes are glowing, fiery orbs. It looks like it is full of hatred and malice, and it seems to relish the thought of causing destruction and chaos.

The princess is standing in the back of the room, she is looking scared.

(From here, you can move to the outside.)

>feed dragon with cake
*** Dragon ate the cake you brought him, but he is still hungry, so you are his food. GAME OVER ***

Would you like to RESTART, RESTORE a saved game, QUIT or UNDO the last command?

* * *

>out
hallway
You can see a Castle Door, Door 1 and Door 2 here.

(From here, you can move to the south, the inside and the outside.)

>inventroy
That's not a verb I recognise.

>inventory
You are carrying:
  a cheesecake
  a nickel key
  a flaming torch (providing light)

* * *

>east
You can see everything. Now you can search for key
garage
You are in the garage. It is a large, cluttered space with a concrete floor and fluorescent lighting.

Here is also the smart fox which is a small, animal with bright, alert eyes, and a bushy tail. It looks sly and cunning, with a sharp, curious gaze that seems to suggest that it is always thinking.

You can also see a cabinet and a rug here.

(From here, you can move to the west.)

>look in cabinet
You find nothing of interest.

>examine cabinet
It is made of sturdy oak and has a smooth, polished finish.

* * *

>open cabinet
It isn't something you can open.

>look cabinet
It is made of sturdy oak and has a smooth, polished finish.

>look rug
You see nothing special about the rug.

>look under the rug
You saw a nickel key under the rug. Keep the key

>west
castle
You are now in front of castle. In order to get into the castle you need to open the Castle Door.

You can see a Castle Door here.

(From here, you can move to the north, the south, the east, the west and the inside.)

* * *

>open fridge
I am very hungry. I want to eat dobosica

>look in frdige
You can't see any such thing.

>look in fridge
In the fridge are a cheesecake, a dobosica and a chocolate cake.

>take chocolate cake
You're carrying too many things already.

>drop wallet
Dropped.

>take chocolate cake
Taken.

* * *

>door 1
You open Door 1.

kitchen
You are in the castle's kitchen. It is a large, well-equipped space with a fireplace, a fridge, and a table in the center. The smell of cooking food fills the air.

The old fridge is a large, white appliance with a dented surface and a handle on the door. It has three cakes inside.

(From here, you can move to the outside.)

>eat dobosica
You can't see any such thing.

>open fridge
I am very hungry. I want to eat dobosica

>open dobosica
It isn't something you can open.

>eat dobosica
(first taking the dobosica)
You're carrying too many things already.

>out
hallway
You can see a Castle Door, Door 1 and Door 2 here.

(From here, you can move to the south, the inside and the outside.)

* * *

>out
castle
You are now in front of castle. In order to get into the castle you need to open the Castle Door.

You can see a Castle Door here.

(From here, you can move to the north, the south, the east, the west and the inside.)

>west
garden
You are now in the garden.

Here is a huge box made of wood with a hinged lid. It is well-worn, with scratches and dents on its surface. It looks like it has been used for storing things for a long time. You can open it and see what is inside.

(From here, you can move to the east.)

>drop wallet
Dropped.

>east
castle
You are now in front of castle. In order to get into the castle you need to open the Castle Door.

You can see a Castle Door here.

(From here, you can move to the north, the south, the east, the west and the inside.)

>north
(first opening the Castle Door)
hallway
You can see a Castle Door, Door 1 and Door 2 here.

(From here, you can move to the south, the inside and the outside.)

* * *

>door 1
kitchen
You are in the castle's kitchen. It is a large, well-equipped space with a fireplace, a fridge, and a table in the center. The smell of cooking food fills the air.

The old fridge is a large, white appliance with a dented surface and a handle on the door. It has three cakes inside.

(From here, you can move to the outside.)

>eat dobosica
(first taking the dobosica)
I am full now.

*** Run-time problem P10: Since the dobosica is not allowed the property "aggravate period", it is against the rules to try to use it.

You are poisoned and have to find a cure if you want to live. The fox has the cure.

Eaten poison occurs in 5 minutes from now, you better find cure

* * *

>east
You can see everything. Now you can search for key
garage
You are in the garage. It is a large, cluttered space with a concrete floor and fluorescent lighting.

Here is also the smart fox which is a small, animal with bright, alert eyes, and a bushy tail. It looks sly and cunning, with a sharp, curious gaze that seems to suggest that it is always thinking.

You can also see a cabinet and a rug here.

(From here, you can move to the west.)

>take nickel key
Taken.

* * *

>door 2
You open Door 2.

Princesses Room
You entered her room, but there is enormous dragon that is very hungry. Give him poisonus cake that will kill it and save princess

The dragon is a massive, fearsome beast. It has wings that stretch out wide, and its eyes are glowing, fiery orbs. It looks like it is full of hatred and malice, and it seems to relish the thought of causing destruction and chaos.

>feed dragon with cheesecake
*** Dragon ate you, because you did not bring him any food. GAME OVER ***

Would you like to RESTART, RESTORE a saved game, QUIT or UNDO the last command?

>undo
Princesses Room
[Previous turn undone.]

>out
hallway
You can see a Castle Door, Door 1 and Door 2 here.

>door 1
You open Door 1.

kitchen
You are in the castle's kitchen. It is a large, well-equipped space with a fireplace, a fridge, and a table in the center. The smell of cooking food fills the air.

The old fridge is a large, white appliance with a dented surface and a handle on the door. It has three cakes inside.

* * *

>inventory
You are carrying:
  a cheesecake
  a nickel key
  a flaming torch (providing light)
  a wallet (closed)

>out
hallway
You can see a Castle Door, Door 1 and Door 2 here.

>door 2
Princesses Room
You entered her room, but there is enormous dragon that is very hungry. Give him poisonus cake that will kill it and save princess

The dragon is a massive, fearsome beast. It has wings that stretch out wide, and its eyes are glowing, fiery orbs. It looks like it is full of hatred and malice, and it seems to relish the thought of causing destruction and chaos.

>feed dragon with cheesecake
You feed the dragon with cheesecake. It is munching it down, grunting happily.

    *** You killed dragon with poisonous cake and saved princess. YOU WON ***

Would you like to RESTART, RESTORE a saved game, QUIT or UNDO the last command?

>undo
Princesses Room
[Previous turn undone.]

* * *

>out
hallway
You can see a Castle Door, Door 1 and Door 2 here.

>door 1
kitchen
You are in the castle's kitchen. It is a large, well-equipped space with a fireplace, a fridge, and a table in the center. The smell of cooking food fills the air.

The old fridge is a large, white appliance with a dented surface and a handle on the door. It has three cakes inside.

>open fridge
That's already open.

>take dobosica
Taken.

>eat dobosica
You are poisoned  and have to find a cure if you want to live. The fox has the cure.

You eat the dobosica. Not bad.

>inventory
You are carrying:
  a cheesecake
  a nickel key
  a flaming torch (providing light)
  a wallet (closed)

* * *

>east
You can see everything. Now you can search for key
garage
You are in the garage. It is a large, cluttered space with a concrete floor and fluorescent lighting. There is a cabinet along one wall, with a variety of tools and a vase with roses on it.

The smart fox is a small, animal with bright, alert eyes, and a bushy tail. It looks sly and cunning, with a sharp, curious gaze that seems to suggest that it is always thinking.

You can also see a cabinet (on which is a vase (in which is a roses)) here.

>examine fox
Hello smart fox, I am poisoned and need the cure. Can you help me?. Fox says: Yes, but you need to answer this riddle. What invention lets you look right through a wall? 
You see nothing special about the fox.

    *** Fox says: That is wrong answer, no cure for you.
Poison is all over your body, you died: GAME OVER ***

Would you like to RESTART, RESTORE a saved game, QUIT or UNDO the last command?

* * *

>open box
You open the box, revealing bag.

>west
You can't go that way.

>open bag
You open bag, revealing a wallet.

* * *

>door 1
You open Door 1.

kitchen
You are in the castle's kitchen. It is a large, well-equipped space with a fireplace, a fridge, and a table in the center. The smell of cooking food fills the air.

The old fridge is a large, white appliance with a dented surface and a handle on the door. It has three cakes inside.

>open frdige
You can't see any such thing.

>open fridge
I am very hungry. I want to eat dobosica

* * *

>north
(first opening the Castle Door)
hallway
You can see a Castle Door, Door 1 and Door 2 here.

>door1
That's not a verb I recognise.

>door 1
You open Door 1.

kitchen
You are in the castle's kitchen. It is a large, well-equipped space with a fireplace, a fridge, and a table in the center. The smell of cooking food fills the air.

The old fridge is a large, white appliance with a dented surface and a handle on the door. It has three cakes inside.

* * *

>examine fox
Hello smart fox, I am poisoned and need the cure. Can you help me?. Fox says: Yes, but you need to answer this riddle. What invention lets you look right through a wall? 
You see nothing special about the fox.

Enter the answer:

>jaj
The fox says: That's wrong, can't give you cure

>examine fox
Hello smart fox, I am poisoned and need the cure. Can you help me?. Fox says: Yes, but you need to answer this riddle. What invention lets you look right through a wall? 
You see nothing special about the fox.

Enter the answer:

* * *

>a window
The fox says: You are right, here is cure

I beg your pardon?

* * *

>open bag
You open bag, revealing a wallet.

>open wallet
You open the wallet, revealing dollar bills.

>take wallet
Amazing, you have money. You can buy items in the old house.

* * *

>south
house
You are now in the old house. It looks like it has been abandoned for some time, but it is still in good repair. There is a male person standing.

It is salesman, who is standing in front of the table, on which are  several gadgets and weaponry. He stares at you intently. You can ask him about the things on the table.

You can also see a table (on which are a sword, a knife and a flaming torch) here.

>buy flamig torch
You can't see any such thing.

>buy flaming torch
You can buy the the sword, the flaming torch or the knife if you have enough money
You hand over cash, now you have 10 dollars remaining. You take the flaming torch from the salesman.

* * *

>take nickel key
Taken.

>examine fox
Do you need something?

You see nothing special about the fox.

>west
castle
You are now in front of castle. In order to get into the castle you need to open the Castle Door.

You can see a Castle Door here.

* * *

>examine fox
Hello smart fox, I am poisoned and need the cure. Can you help me?. Fox says: Yes, but you need to answer this riddle. What invention lets you look right through a wall? 
You see nothing special about the fox.

    *** Fox says: That is wrong answer, no cure for you.
Poison is all over your body, you died: GAME OVER ***

Would you like to RESTART, RESTORE a saved game, QUIT or UNDO the last command?

>undo
garage
[Previous turn undone.]

>north
You can't go that way.

* * *

>west
castle
You are now in front of castle. In order to get into the castle you need to open the Castle Door.

You can see a Castle Door here.

>east
You can see everything. Now you can search for key
garage
You are in the garage. It is a large, cluttered space with a concrete floor and fluorescent lighting. There is a cabinet along one wall, with a variety of tools and a vase with roses on it.

The smart fox is a small, animal with bright, alert eyes, and a bushy tail. It looks sly and cunning, with a sharp, curious gaze that seems to suggest that it is always thinking.

You can also see a cabinet (on which is a vase (in which is a roses)) here.

>east
You can't go that way.

>west
castle
You are now in front of castle. In order to get into the castle you need to open the Castle Door.

You can see a Castle Door here.

* * *

>north
(first opening the Castle Door)
hallway
You can see a Castle Door, Door 1 and Door 2 here.

>door 2
You open Door 2.

Princesses Room
You entered her room, but there is enormous dragon that is very hungry. Give him poisonus cake that will kill it and save princess

>feed with cheescake
You can't see any such thing.

>feed the dragon with cheesecake
You can't see any such thing.

>feed dragon with cheesecake
You can't see any such thing.

* * *

>door 1
You open Door 1.

kitchen
You are in the castle's kitchen. It is a large, well-equipped space with a fireplace, a fridge, and a table in the center. The smell of cooking food fills the air.

The old fridge is a large, white appliance with a dented surface and a handle on the door. It has three cakes inside.

>out
hallway
You can see a Castle Door, Door 1 and Door 2 here.

* * *

>east
You can see everything. Now you can search for key
garage
You are in the garage. It is a large, cluttered space with a concrete floor and fluorescent lighting. There is a cabinet along one wall, with a variety of tools and a vase with roses on it.

The smart fox is a small, animal with bright, alert eyes, and a bushy tail. It looks sly and cunning, with a sharp, curious gaze that seems to suggest that it is always thinking.

You can also see a cabinet (on which is a vase (in which is a roses)) here.

>examine fox
Do you need something?

You see nothing special about the fox.

* * *

>north
(first opening the Castle Door)
hallway
You can see a Castle Door, Door 1 and Door 2 here.

>door 1
kitchen
You are in the castle's kitchen. It is a large, well-equipped space with a fireplace, a fridge, and a table in the center. The smell of cooking food fills the air.

The old fridge is a large, white appliance with a dented surface and a handle on the door. It has three cakes inside.

>examine firdge
You can't see any such thing.

>examine fridge
In the fridge are a cheescake, a dobosica and a chocolate cake.

I am very hungry. I want to eat dobosica

>eat dobosica
You are poisoned  and have to find a cure if you want to live. The fox has the cure.

(first taking the dobosica)
You eat the dobosica. Not bad.

* * *

>a window
The fox says: You are right, here is cure

>inventory
You are carrying:
  a nickel key
  a flaming torch (providing light)
  a wallet (open)
    20 dollar bills

>examine fox
Hello smart fox, I am poisoned and need the cure. Can you help me?. Fox says: Yes, but you need to answer this riddle. What invention lets you look right through a wall? 
You see nothing special about the fox.

Enter the answer:

>lol
The fox says: That is wrong answer, no cure for youThat's not a verb I recognise.

Enter the answer:

* * *

>buy sword
You can buy the the sword, the flaming torch or the knife
You hand over cash, now you have 0 dollars remaining. You take the sword from the salesman.

>buy flaming torch
You do not have enough cash to buy the sword.

* * *

>south
house
You are now in the old house. It looks like it has been abandoned for some time, but it is still in good repair. There is a male person standing.

It is salesman, who is standing with a briefcase in his hand which is filled with several gadgets and weaponry. He stares at you intently.

>buy the flaming torch
You hand over cash, now you have 10 dollars remaining. You take the thing from the salesman.

Nothing is on sale.

>north
castle
The walls are made of stone, and the floors are polished marble. There are various doors and hallway leading off in different directions.

You can see a Castle Door here.

* * *

>west
garden
You can see thhe hudge box made of wood with a hinged lid. It is well-worn, with scratches and dents on its surface. It looks like it has been used for storing things for a long time.

>east
castle
The walls are made of stone, and the floors are polished marble. There are various doors and hallway leading off in different directions.

You can see a Castle Door here.

>east
garage
It is dark in here. In order to see something you must have a flaming torch.

The smart fox is a small, animal with bright, alert eyes, and a bushy tail. It looks sly and cunning, with a sharp, curious gaze that seems to suggest that it is always thinking.

You can also see a table (on which is a vase (in which are a nickel key and Rose)) here.

You can see everything. Now you can search for key
You would have to get out of the garage first.

>examine fox
Do you need something?

You see nothing special about the fox.

>examine table
It is made of sturdy oak and has a smooth, polished finish. There is a vase with flowers in it.

On the table is a vase (in which are a nickel key and Rose).

>remove Rose from the vase
You picked roses from the vase and can see the nickel key. Keep the key

>west
castle
The walls are made of stone, and the floors are polished marble. There are various doors and hallway leading off in different directions.

You can see a Castle Door here.

>north
(first opening the Castle Door)
hallway
You can see a Castle Door, Door 1 and Door 2 here.

* * *

>door 1
You open Door 1.

kitchen
You are in the castle's kitchen. It is a large, well-equipped space with a fireplace, a fridge, and a table in the center. The smell of cooking food fills the air.

The old fridge is a large, white appliance with a dented surface and a handle on the door. It has three cakes inside.

>open fridge
That's already open.

>examine fridge
In the fridge are a cheescake, a dobosica and a chocolate cake.

I am very hungry. I want to eat dobosica

* * *

>eat dobosica
You are poisoned  and have to find a cure if you want to live. The fox has the cure.

(first taking the dobosica)
You eat the dobosica. Not bad.

>outside
hallway
You can see a Castle Door, Door 1 and Door 2 here.

>castle door
That's not a verb I recognise.

>a castle door
That's not a verb I recognise.

>south
(first opening the Castle Door)
hallway
You can see a Castle Door, Door 1 and Door 2 here.

>outside
You can't go that way.

>south
(first opening the Castle Door)
hallway
You can see a Castle Door, Door 1 and Door 2 here.

>a castle door
That's not a verb I recognise.

>a Castle Soor
That's not a verb I recognise.

>a Castle Door
That's not a verb I recognise.

>south
(first opening the Castle Door)
hallway
You can see a Castle Door, Door 1 and Door 2 here.

>south
(first opening the Castle Door)
hallway
You can see a Castle Door, Door 1 and Door 2 here.

* * *

>take wallet
Amazing, you have money. You can buy items in the old house.

I beg your pardon?

>east
castle
You are now in front of castle. In order to get into the castle you need to open the Castle Door.

You can see a Castle Door here.

* * *

>door 2
You open Door 2.

Princesses Room
You entered her room, but there is enormous dragon that is very hungry. Give him poisonus cake that will kill it and save princess

The dragon is a massive, fearsome beast. It has wings that stretch out wide, and its eyes are glowing, fiery orbs. It looks like it is full of hatred and malice, and it seems to relish the thought of causing destruction and chaos.

>examine dragon
You see nothing special about the dragon.

* * *

>east
castle
You are now in front of castle. In order to get into the castle you need to open the Castle Door.

You can see a Castle Door here.

(From here, you can move to the north, the south, the east, the west and the inside.)

>north
(first opening the Castle Door)
The Castle Door is locked.
Search for the key in the garage.

>south
house
You are now in the old house. It looks like it has been abandoned for some time, but it is still in good repair. There is a male person standing.

It is salesman, who is standing in front of the table, on which are  several gadgets and weaponry. He stares at you intently. You can ask him about the things on the table.

You can also see a table (on which are a sword, a knife and a flaming torch) here.

(From here, you can move to the north.)

>buy the flaming torch
Salesman says: You can buy the the sword, the flaming torch or the knife if you have enough money

I want to buy the flaming torch

You hand over cash, now you have 10 dollars remaining.
You take the flaming torch from the salesman.

>north
castle
You are now in front of castle. In order to get into the castle you need to open the Castle Door.

You can see a Castle Door here.

(From here, you can move to the north, the south, the east, the west and the inside.)

>east
You can see everything. Now you can search for key
garage
You are in the garage. It is a large, cluttered space with a concrete floor and fluorescent lighting. There is a cabinet along one wall, with a variety of tools and a vase with roses on it.

Here is also the smart fox which is a small, animal with bright, alert eyes, and a bushy tail. It looks sly and cunning, with a sharp, curious gaze that seems to suggest that it is always thinking.

(From here, you can move to the west.)

>examine cabinet
You can't see any such thing.

>examine the cabinet
You can't see any such thing.

* * *

>south
house
You are now in the old house. It looks like it has been abandoned for some time, but it is still in good repair. There is a male person standing.

It is salesman, who is standing in front of the table, on which are  several gadgets and weaponry. He stares at you intently. You can ask him about the things on the table.

You can also see a table (on which are a sword, a knife and a flaming torch) here.

(From here, you can move to the north and the west.)

>buy flamig torch
You can't see any such thing.

>buy flaming torch
Salesman says: You can buy the the sword, the flaming torch or the knife if you have enough money

I want to buy the flaming torch

You hand over cash, now you have 10 dollars remaining.
You take the flaming torch from the salesman.

* * *

>examine the cabinet
You can't see any such thing.

>look cabinet
You can't see any such thing.

>look
garage
You are in the garage. It is a large, cluttered space with a concrete floor and fluorescent lighting. There is a cabinet along one wall, with a variety of tools and a vase with roses on it.

Here is also the smart fox which is a small, animal with bright, alert eyes, and a bushy tail. It looks sly and cunning, with a sharp, curious gaze that seems to suggest that it is always thinking.

(From here, you can move to the west.)

* * *

>out
castle
You are now in front of castle. In order to get into the castle you need to open the Castle Door.

You can see a Castle Door here.

(From here, you can move to the north, the south, the east, the west and the inside.)

>inside
hallway
You can see a Castle Door, Door 1 and Door 2 here.

(From here, you can move to the south, the inside and the outside.)

* * *

>examine fox
Hello smart fox, I am poisoned and need the cure. Can you help me?.
Fox says:  Yes, but you need to answer this riddle. 
What invention lets you look right through a wall? 
Enter the answer:

>jaja
That's not a verb I recognise.

Enter the answer:

>jdj
That's not a verb I recognise.

Enter the answer:

>a window
The fox says: You are right, here is cure

>drink cure
*** The fox says: That's wrong, can't give you cure ***

Would you like to RESTART, RESTORE a saved game, QUIT or UNDO the last command?

* * *

>east
You can see everything. Now you can search for key
garage
You are in the garage. It is a large, cluttered space with a concrete floor and fluorescent lighting.

Here is also the smart fox which is a small, animal with bright, alert eyes, and a bushy tail. It looks sly and cunning, with a sharp, curious gaze that seems to suggest that it is always thinking.

You can also see a cabinet and a rug here.

(From here, you can move to the west.)

>examine vase
In the vase are a nickel key and a roses.

* * *

>east
You can see everything. Now you can search for key
garage
You are in the garage. It is a large, cluttered space with a concrete floor and fluorescent lighting. There is a cabinet along one wall, with a variety of tools and a vase with roses on it.

The smart fox is a small, animal with bright, alert eyes, and a bushy tail. It looks sly and cunning, with a sharp, curious gaze that seems to suggest that it is always thinking.

You can also see a cabinet (on which is a vase (in which is a roses)) here.

>eaxmine foy
That's not a verb I recognise.

>eaxmine fox
That's not a verb I recognise.

>examine fox
Hello smart fox, I am poisoned and need the cure. Can you help me?. Fox says: Yes, but you need to answer this riddle. What invention lets you look right through a wall? 
You see nothing special about the fox.

Enter the answer:

* * *

>a window
The fox says: You are right, here is cure

>drink cure
There's nothing suitable to drink here.

>drink
What do you want to drink?

>cure
There's nothing suitable to drink here.

>examine fox
Hello smart fox, I am poisoned and need the cure. Can you help me?. Fox says: Yes, but you need to answer this riddle. What invention lets you look right through a wall? 
You see nothing special about the fox.

Enter the answer:

* * *

>nes
That's not a verb I recognise.

>examine fox
Hello smart fox, I am poisoned and need the cure. Can you help me?. Fox says: Yes, but you need to answer this riddle. What invention lets you look right through a wall? 
You see nothing special about the fox.

Enter the answer:

* * *

>a window
The fox says: You are right, here is cure

>take cure
You already have that.

>drink cure
There's nothing suitable to drink here.

>report cure
That's not a verb I recognise.

>report drinking
That's not a verb I recognise.

>drink cure
There's nothing suitable to drink here.

* * *

>examine fox
Hello smart fox, I am poisoned and need the cure. Can you help me?. Fox says: Yes, but you need to answer this riddle. What invention lets you look right through a wall? 
You see nothing special about the fox.

Enter the answer:

>jaj
That's not a verb I recognise.

Enter the answer:

>jaj
That's not a verb I recognise.

Enter the answer:

>fja
That's not a verb I recognise.

Enter the answer:

>a window
The fox says: You are right, here is cure

>akd
That's not a verb I recognise.

>dkdk
That's not a verb I recognise.

* * *

>door 1
You open Door 1.

kitchen
You are in the castle's kitchen. It is a large, well-equipped space with a fireplace, a fridge, and a table in the center. The smell of cooking food fills the air.

The old fridge is a large, white appliance with a dented surface and a handle on the door. It has three cakes inside.

>examine fridge
In the fridge are a cheescake, a dobosica and a chocolate cake.

I am very hungry. I want to eat dobosica

* * *

>examine fox
Hello smart fox, I am poisoned and need the cure. Can you help me?. Fox says: Yes, but you need to answer this riddle. What invention lets you look right through a wall? 
You see nothing special about the fox.

Enter the answer:

>lol
That's not a verb I recognise.

Enter the answer:

>a window
The fox says: You are right, here is cure

>drink cure
*** Fox says: That is wrong answer, no cure for you.
Poison is all over your body, you died: GAME OVER ***

Would you like to RESTART, RESTORE a saved game, QUIT or UNDO the last command?

* * *

>east
You can see everything. Now you can search for key
garage
You are in the garage. It is a large, cluttered space with a concrete floor and fluorescent lighting.

Here is also the smart fox which is a small, animal with bright, alert eyes, and a bushy tail. It looks sly and cunning, with a sharp, curious gaze that seems to suggest that it is always thinking.

You can also see a cabinet and a rug here.

(From here, you can move to the west.)

>look under rug
You saw a nickel key under the rug. Keep the key, you need it for unlocking Castle Door

>west
castle
You are now in front of castle. In order to get into the castle you need to open the Castle Door.

You can see a Castle Door here.

(From here, you can move to the north, the south, the east, the west and the inside.)

* * *

>door 1
You open Door 1.

kitchen
You are in the castle's kitchen. It is a large, well-equipped space with a fireplace, a fridge, and a table in the center. The smell of cooking food fills the air.

The old fridge is a large, white appliance with a dented surface and a handle on the door. It has three cakes inside.

(From here, you can move to the outside.)

>open frdige
You can't see any such thing.

* * *

>drop wallet
Dropped.

>eat dobosica
(first taking the dobosica)
You are poisoned and have to find a cure if you want to live. The fox has the cure.

You are poisoned, because the cake you've eaten has poison in it. Now you have to find a cure if you want to live. The fox has the cure.

>out
hallway
You can see a Castle Door, Door 1 and Door 2 here.

(From here, you can move to the south, the inside and the outside.)

* * *

>east
You can see everything. Now you can search for key
garage
You are in the garage. It is a large, cluttered space with a concrete floor and fluorescent lighting.

Here is also the smart fox which is a small, animal with bright, alert eyes, and a bushy tail. It looks sly and cunning, with a sharp, curious gaze that seems to suggest that it is always thinking.

You can also see a cabinet and a rug here.

(From here, you can move to the west.)

>west
castle
You are now in front of castle. In order to get into the castle you need to open the Castle Door.

You can see a Castle Door here.

(From here, you can move to the north, the south, the east, the west and the inside.)

You eaten poisonous cake, you will die in 4 minutes from now if you do not find cure

>east
You can see everything. Now you can search for key
garage
You are in the garage. It is a large, cluttered space with a concrete floor and fluorescent lighting.

Here is also the smart fox which is a small, animal with bright, alert eyes, and a bushy tail. It looks sly and cunning, with a sharp, curious gaze that seems to suggest that it is always thinking.

You can also see a cabinet and a rug here.

(From here, you can move to the west.)

* * *

>drink cure
You slurp down the cure. Refreshing!

>west
castle
You are now in front of castle. In order to get into the castle you need to open the Castle Door.

You can see a Castle Door here.

(From here, you can move to the north, the south, the east, the west and the inside.)

* * *

>door 1
kitchen
You are in the castle's kitchen. It is a large, well-equipped space with a fireplace, a fridge, and a table in the center. The smell of cooking food fills the air.

The old fridge is a large, white appliance with a dented surface and a handle on the door. It has three cakes inside.

You can also see a wallet (closed) here.

(From here, you can move to the outside.)

>examine fridge
In the fridge are a chocolate cake and a cheesecake.

>take chocolate cake
Taken.

* * *

>out
hallway
You can see a Castle Door, Door 1 and Door 2 here.

(From here, you can move to the south, the inside and the outside.)

>door 1
kitchen
You are in the castle's kitchen. It is a large, well-equipped space with a fireplace, a fridge, and a table in the center. The smell of cooking food fills the air.

The old fridge is a large, white appliance with a dented surface and a handle on the door. It has three cakes inside.

You can also see a wallet (closed) here.

(From here, you can move to the outside.)

>examine fridge
In the fridge is a cheesecake.

>drop chocolate cake
Dropped.

* * *

>door 2
Princesses Room
You entered her room, but there is enormous dragon that is very hungry. Feed it with a poisonus cake and save princess

The dragon is a massive, fearsome beast. It has wings that stretch out wide, and its eyes are glowing, fiery orbs. It looks like it is full of hatred and malice, and it seems to relish the thought of causing destruction and chaos.

The princess is standing in the back of the room, she is looking scared.

(From here, you can move to the outside.)

>feed dragon with cake
You feed the dragon with cake. It is munching it down.

    *** You killed dragon with poisonous cake and saved princess. YOU WON ***

Would you like to RESTART, RESTORE a saved game, QUIT or UNDO the last command?

* * *

>drop wallet
Dropped.

>open fridge
I am very hungry. I want to eat dobosica

* * *

>door 2
You are in Princesses room, but you can see enormous dragon that is very hungry.

You open Door 2.

Princesses Room
You entered her room, but there is enormous dragon that is very hungry. Feed it with a poisonus cake and save princess

The dragon is a massive, fearsome beast. It has wings that stretch out wide, and its eyes are glowing, fiery orbs. It looks like it is full of hatred and malice, and it seems to relish the thought of causing destruction and chaos.

The princess is standing in the back of the room, she is looking scared.

(From here, you can move to the outside.)

>feed dragon with cake
You feed the dragon with cake. It is munching it down.

    *** You killed dragon with poisonous cake and saved princess. YOU WON ***

Would you like to RESTART, RESTORE a saved game, QUIT or UNDO the last command?

>undo
Princesses Room
[Previous turn undone.]

* * *

>door 1
kitchen
You are in the castle's kitchen. It is a large, well-equipped space with a fireplace, a fridge, and a table in the center. The smell of cooking food fills the air.

The old fridge is a large, white appliance with a dented surface and a handle on the door. It has three cakes inside.

You can also see a wallet (closed) here.

(From here, you can move to the outside.)

>drop cheesecake
Dropped.

>take dobosica
Taken.

>out
hallway
You can see a Castle Door, Door 1 and Door 2 here.

(From here, you can move to the south, the inside and the outside.)

>door 1
kitchen
You are in the castle's kitchen. It is a large, well-equipped space with a fireplace, a fridge, and a table in the center. The smell of cooking food fills the air.

The old fridge is a large, white appliance with a dented surface and a handle on the door. It has three cakes inside.

You can also see a cheesecake and a wallet (closed) here.

(From here, you can move to the outside.)

>drop dobosica
Dropped.

>take chocolate cake
Taken.

* * *

>door 2
Princesses Room
You entered her room, but there is enormous dragon that is very hungry. Feed it with a poisonus cake and save princess

The dragon is a massive, fearsome beast. It has wings that stretch out wide, and its eyes are glowing, fiery orbs. It looks like it is full of hatred and malice, and it seems to relish the thought of causing destruction and chaos.

The princess is standing in the back of the room, she is looking scared.

(From here, you can move to the outside.)

>take chocolate cake
You already have that.

>feed dragon with cake
*** Dragon ate the cake you brought him, but he is still hungry, so you are his food. GAME OVER ***

Would you like to RESTART, RESTORE a saved game, QUIT or UNDO the last command?

* * *

>feed dragon with cake
You feed the dragon with cake. It is munching it down.

    *** You killed dragon with poisonous cake and saved princess. YOU WON ***

Would you like to RESTART, RESTORE a saved game, QUIT or UNDO the last command?

>unod
Please give one of the answers above.

Would you like to RESTART, RESTORE a saved game, QUIT or UNDO the last command?

>undo
Princesses Room
[Previous turn undone.]

* * *

>open fridge
I am very hungry. I want to eat dobosica

>drop wallet
Dropped.

* * *

>east
You can see everything. Now you can search for key
garage
You are in the garage. It is a large, cluttered space with a concrete floor and fluorescent lighting.

Here is also the smart fox which is a small, animal with bright, alert eyes, and a bushy tail. It looks sly and cunning, with a sharp, curious gaze that seems to suggest that it is always thinking.

You can also see a cabinet and a rug here.

(From here, you can move to the west.)

>examine fox
Hello smart fox, I am poisoned and need the cure. Can you help me?.
Fox says:  Yes, but you need to answer this riddle. 
What invention lets you look right through a wall? 
Eaten poison occurs in 4 minutes from now, you better find cure
Enter the answer:

>a window
The fox says: You are right, here is cure

* * *

>west
castle
You are now in front of castle. In order to get into the castle you need to open the Castle Door.

You can see a Castle Door here.

(From here, you can move to the north, the south, the east, the west and the inside.)

>inventory
You are carrying:
  a nickel key
  a flaming torch (providing light)

>north
(first opening the Castle Door)
hallway
You can see a Castle Door, Door 1 and Door 2 here.

(From here, you can move to the south, the inside and the outside.)

>out
castle
You are now in front of castle. In order to get into the castle you need to open the Castle Door.

You can see a Castle Door here.

(From here, you can move to the north, the south, the east, the west and the inside.)

>south
house
You are now in the old house. It looks like it has been abandoned for some time, but it is still in good repair. There is a male person standing.

It is salesman, who is standing in front of the table, on which are  several gadgets and weaponry. He stares at you intently. You can ask him about the things on the table.

You can also see a table (on which are a sword and a knife) here.

(From here, you can move to the north and the west.)

>west
forest
You are standing in a dense forest. The trees are tall and their branches form a canopy overhead, blocking out most of the sunlight. There is a faint path winding through the underbrush, leading east and west.

(From here, you can move to the east.)

>east
You follow the east path deeper into the forest and got to the old house.

house
You are now in the old house. It looks like it has been abandoned for some time, but it is still in good repair. There is a male person standing.

It is salesman, who is standing in front of the table, on which are  several gadgets and weaponry. He stares at you intently. You can ask him about the things on the table.

You can also see a table (on which are a sword and a knife) here.

(From here, you can move to the north and the west.)

>north
castle
You are now in front of castle. In order to get into the castle you need to open the Castle Door.

You can see a Castle Door here.

(From here, you can move to the north, the south, the east, the west and the inside.)

>north
(first opening the Castle Door)
hallway
You can see a Castle Door, Door 1 and Door 2 here.

(From here, you can move to the south, the inside and the outside.)

>door 2
You are in Princesses room, but you can see enormous dragon that is very hungry.

You open Door 2.

Princesses Room
You entered her room, but there is enormous dragon that is very hungry. Feed it with a poisonus cake and save princess

The dragon is a massive, fearsome beast. It has wings that stretch out wide, and its eyes are glowing, fiery orbs. It looks like it is full of hatred and malice, and it seems to relish the thought of causing destruction and chaos.

The princess is standing in the back of the room, she is looking scared.

(From here, you can move to the outside.)

* * *

>drop wallet
Dropped.

>take cheesecake
*** Run-time problem P10: Since the chocolate cake is not allowed the property "poisoned", it is against the rules to try to use it.

* * *

>east
You can see everything. Now you can search for key
garage
You are in the garage. It is a large, cluttered space with a concrete floor and fluorescent lighting.

Here is also the smart fox which is a small, animal with bright, alert eyes, and a bushy tail. It looks sly and cunning, with a sharp, curious gaze that seems to suggest that it is always thinking.

You can also see a cabinet and a rug here.

(From here, you can move to the west.)

>look under the cabinet
You find nothing of interest.

>look under the rug
You saw a nickel key under the rug. Keep the key

* * *

>open fridge
I am very hungry. I want to eat dobosica

>take dobosica
You're carrying too many things already.

>drop wallet
Dropped.

>take dobosica
Taken.

>inventory
You are carrying:
  a dobosica
  a nickel key
  a flaming torch (providing light)

>out
hallway
You can see a Castle Door, Door 1 and Door 2 here.

(From here, you can move to the south, the inside and the outside.)

>door 2
You are in Princesses room, but you can see enormous dragon that is very hungry.

You open Door 2.

Princesses Room
You entered her room, but there is enormous dragon that is very hungry. Give him poisonus cake that will kill it and save princess

The dragon is a massive, fearsome beast. It has wings that stretch out wide, and its eyes are glowing, fiery orbs. It looks like it is full of hatred and malice, and it seems to relish the thought of causing destruction and chaos.

The princess is standing in some room in the castle, she is looking worried.

(From here, you can move to the outside.)

>feed dragon with dobosica
You can't see any such thing.

>feed dragon with cake
You feed the dragon with cake. It is munching it down.

    *** You killed dragon with poisonous cake and saved princess. YOU WON ***

Would you like to RESTART, RESTORE a saved game, QUIT or UNDO the last command?

* * *

>east
You can see everything. Now you can search for key
garage
You are in the garage. It is a large, cluttered space with a concrete floor and fluorescent lighting.

Here is also the smart fox which is a small, animal with bright, alert eyes, and a bushy tail. It looks sly and cunning, with a sharp, curious gaze that seems to suggest that it is always thinking.

You can also see a cabinet and a rug here.

(From here, you can move to the west.)

>open vase
You open the vase, revealing a nickel key and a roses.

>take nickel key
Taken.

* * *

>east
You can see everything. Now you can search for key
garage
You are in the garage. It is a large, cluttered space with a concrete floor and fluorescent lighting.

Here is also the smart fox which is a small, animal with bright, alert eyes, and a bushy tail. It looks sly and cunning, with a sharp, curious gaze that seems to suggest that it is always thinking.

You can also see a cabinet and a rug here.

(From here, you can move to the west.)

>remove Rose from the vase
You picked roses from the vase and can see the nickel key. Keep the key

* * *

>outside
hallway
You can see a Castle Door, Door 1 and Door 2 here.

>outside
castle
The walls are made of stone, and the floors are polished marble. There are various doors and hallway leading off in different directions.

You can see a Castle Door here.

>east
garage
It is dark in here. In order to see something you must have a flaming torch.

The smart fox is a small, animal with bright, alert eyes, and a bushy tail. It looks sly and cunning, with a sharp, curious gaze that seems to suggest that it is always thinking.

You can also see a table (on which is a vase (in which is Rose)) here.

You can see everything. Now you can search for key
You would have to get out of the garage first.

>examine fox
Hello smart fox, I am poisoned and need the cure. Can you help me?. Fox says: Yes, but you need to answer this riddle. What invention lets you look right through a wall? 
You see nothing special about the fox.

Enter the answer:

>no se
The fox says: That is wrong answer, no cure for youI only understood you as far as wanting to no.

Enter the answer:

>a window
The fox says: You are right, here is cureThat's not a verb I recognise.

Enter the answer:

* * *

>east
You can see everything. Now you can search for key
garage
You are in the garage. It is a large, cluttered space with a concrete floor and fluorescent lighting.

Here is also the smart fox which is a small, animal with bright, alert eyes, and a bushy tail. It looks sly and cunning, with a sharp, curious gaze that seems to suggest that it is always thinking.

You can also see a cabinet and a rug here.

(From here, you can move to the west.)

>remove the Rose from the vase
You picked roses from the vase and can see the nickel key. Keep the key

* * *

>north
(first opening the Castle Door)
hallway
You can see a Castle Door, Door 1 and Door 2 here.

>door 1
You open Door 1.

kitchen
You are in the castle's kitchen. It is a large, well-equipped space with a fireplace, a fridge, and a table in the center.

* * *

>east
You can see everything. Now you can search for key
garage
You are in the garage. It is a large, cluttered space with a concrete floor and fluorescent lighting.

Here is also the smart fox which is a small, animal with bright, alert eyes, and a bushy tail. It looks sly and cunning, with a sharp, curious gaze that seems to suggest that it is always thinking.

You can also see a cabinet and a rug here.

(From here, you can move to the west.)

>take nickel kex
I only understood you as far as wanting to take the nickel key.

>take nickel kex
I only understood you as far as wanting to take the nickel key.

>take nickel key
Taken.

* * *

>a window
The fox says: You are right, here is cure

>drinking cure
That's not a verb I recognise.

>drinki cure
That's not a verb I recognise.

>to drink cure
That's not a verb I recognise.

>to drink the cure
That's not a verb I recognise.

>to drink acure
That's not a verb I recognise.

>to drink a cure
That's not a verb I recognise.

>drink a cure
You slurp down the cure. Refreshing!

There's nothing suitable to drink here.

>inventroy
That's not a verb I recognise.

>inventory
You are carrying:
  a cure
  a nickel key
  a flaming torch (providing light)
  a wallet (closed)

* * *

>east
You can see everything. Now you can search for key
garage
You are in the garage. It is a large, cluttered space with a concrete floor and fluorescent lighting. There is a cabinet along one wall, with a variety of tools and a vase with roses on it.

The smart fox is a small, animal with bright, alert eyes, and a bushy tail. It looks sly and cunning, with a sharp, curious gaze that seems to suggest that it is always thinking.

You can also see a cabinet (on which is a vase (in which is a roses)) here.

>examine foc
You can't see any such thing.

>examine fox
Hello smart fox, I am poisoned and need the cure. Can you help me?. Fox says: Yes, but you need to answer this riddle. What invention lets you look right through a wall? 
You see nothing special about the fox.

Enter the answer:

>haha
The fox says: That's wrong, can't give you cureThat's not a verb I recognise.

Enter the answer:

>a window
The fox says: You are right, here is cure

* * *

>examine fox
Hello smart fox, I am poisoned and need the cure. Can you help me?. Fox says: Yes, but you need to answer this riddle. What invention lets you look right through a wall? 
You see nothing special about the fox.

    *** Fox says: That is wrong answer, no cure for you.
Poison is all over your body, you died: GAME OVER ***

Would you like to RESTART, RESTORE a saved game, QUIT or UNDO the last command?

>a window
The fox says: You are right, here is cure

>drink a cure
You slurp down the cure. Refreshing!

That isn't available.

>inventroy
That's not a verb I recognise.

>inventory
You are carrying:
  a nickel key
  a flaming torch (providing light)
  a wallet (closed)

* * *

>examine fox
Hello smart fox, I am poisoned and need the cure. Can you help me?. Fox says: Yes, but you need to answer this riddle. What invention lets you look right through a wall? 
You see nothing special about the fox.

    *** Fox says: That is wrong answer, no cure for you.
Poison is all over your body, you died: GAME OVER ***

Would you like to RESTART, RESTORE a saved game, QUIT or UNDO the last command?

>kak
The fox says: That's wrong, can't give you cure

>examine fox
Hello smart fox, I am poisoned and need the cure. Can you help me?. Fox says: Yes, but you need to answer this riddle. What invention lets you look right through a wall? 
Enter the answer:

* * *

>north
(first opening the Castle Door)
hallway
You can see a Castle Door, Door 1 and Door 2 here.

>door 2
*** Dragon ate you, because you did not bring him any food. GAME OVER ***

Would you like to RESTART, RESTORE a saved game, QUIT or UNDO the last command?

>examine dragon
You see nothing special about the dragon.

* * *

>door 2
*** Dragon ate you, because you did not bring him any food. GAME OVER ***

Would you like to RESTART, RESTORE a saved game, QUIT or UNDO the last command?

>open fridge
You can't see any such thing.

>feed dragon with cheesecake
*** You killed dragon with poisonous cake and saved princess. ***

Would you like to RESTART, RESTORE a saved game, QUIT or UNDO the last command?

>undo
Princesses Room
[Previous turn undone.]

>inventoy
That's not a verb I recognise.

>inventory
You are carrying:
  a nickel key
  a flaming torch (providing light)
  a wallet (closed)

>out
hallway
You can see a Castle Door, Door 1 and Door 2 here.

* * *

>door 2
Princesses Room
You entered her room, but there is enormous dragon that is very hungry. Give him poisonus cake that will kill it and save princess

The dragon is a massive, fearsome beast. It has wings that stretch out wide, and its eyes are glowing, fiery orbs. It looks like it is full of hatred and malice, and it seems to relish the thought of causing destruction and chaos.

>feed dragon with cheesecake
*** You killed dragon with poisonous cake and saved princess. ***

Would you like to RESTART, RESTORE a saved game, QUIT or UNDO the last command?

* * *

>north
castle
You are now in front of castle. In order to get into the castle you need to open the Castle Door.

You can see a Castle Door here.

(From here, you can move to the north, the south, the east, the west and the inside.)

>easz
That's not a verb I recognise.

>east
You can see everything. Now you can search for key
garage
You are in the garage. It is a large, cluttered space with a concrete floor and fluorescent lighting.

Here is also the smart fox which is a small, animal with bright, alert eyes, and a bushy tail. It looks sly and cunning, with a sharp, curious gaze that seems to suggest that it is always thinking.

You can also see a cabinet and a rug here.

(From here, you can move to the west.)

* * *

>look under rug
You saw a nickel key under the rug. Keep the key

>inventory
You are carrying:
  a nickel key
  a flaming torch (providing light)
  a wallet (closed)

>west
castle
You are now in front of castle. In order to get into the castle you need to open the Castle Door.

You can see a Castle Door here.

(From here, you can move to the north, the south, the east, the west and the inside.)

* * *

>drop wallet
Dropped.

>eat dobosica
(first taking the dobosica)
You are poisoned and have to find a cure if you want to live. The fox has the cure.

You eat the dobosica. Not bad.

>out
hallway
You can see a Castle Door, Door 1 and Door 2 here.

(From here, you can move to the south, the inside and the outside.)

* * *

>east
You can see everything. Now you can search for key
garage
You are in the garage. It is a large, cluttered space with a concrete floor and fluorescent lighting.

Here is also the smart fox which is a small, animal with bright, alert eyes, and a bushy tail. It looks sly and cunning, with a sharp, curious gaze that seems to suggest that it is always thinking.

You can also see a cabinet and a rug here.

(From here, you can move to the west.)

>examine fox
Hello smart fox, I am poisoned and need the cure. Can you help me?.
Fox says:  Yes, but you need to answer this riddle. What invention lets you look right through a wall? 
You see nothing special about the fox.

Enter the answer:

>dont know
The fox says: That's wrong, can't give you cure

>examine fox
Hello smart fox, I am poisoned and need the cure. Can you help me?.
Fox says:  Yes, but you need to answer this riddle. What invention lets you look right through a wall? 
You see nothing special about the fox.

Enter the answer:

>a window
The fox says: You are right, here is cure

* * *

>drink cure
There's nothing suitable to drink here.

>drink the cure
There's nothing suitable to drink here.

>drink a cure
There's nothing suitable to drink here.

>inventory
You are carrying:
  a cure
  a nickel key
  a flaming torch (providing light)

* * *

>north
castle
You are now in front of castle. In order to get into the castle you need to open the Castle Door.

You can see a Castle Door here.

(From here, you can move to the north, the south, the east, the west and the inside.)

>eat
What do you want to eat?

>east
You can't see any such thing.

>east
You can see everything. Now you can search for key
garage
You are in the garage. It is a large, cluttered space with a concrete floor and fluorescent lighting. There is a cabinet along one wall, with a variety of tools and a vase with roses on it.

The smart fox is a small, animal with bright, alert eyes, and a bushy tail. It looks sly and cunning, with a sharp, curious gaze that seems to suggest that it is always thinking.

You can also see a cabinet (on which is a vase (in which are a nickel key and a roses)) here.

* * *

>door 2
You open Door 2.

Princesses Room
You entered her room, but there is enormous dragon that is very hungry. Give him poisonus cake that will kill it and save princess

>feed dragon with cheesecake
You can't see any such thing.

* * *

>east
You can see everything. Now you can search for key
garage
You are in the garage. It is a large, cluttered space with a concrete floor and fluorescent lighting. There is a cabinet along one wall, with a variety of tools and a vase with roses on it.

The smart fox is a small, animal with bright, alert eyes, and a bushy tail. It looks sly and cunning, with a sharp, curious gaze that seems to suggest that it is always thinking.

You can also see a cabinet (on which is a vase (in which is a roses)) here.

>exmine fox
That's not a verb I recognise.

>examine fox
Hello smart fox, I am poisoned and need the cure. Can you help me?. Fox says: Yes, but you need to answer this riddle. What invention lets you look right through a wall? 
Enter the answer:

>jaj
The fox says: That's wrong, can't give you cure

>jaj
That's not a verb I recognise.

>examine fox
Hello smart fox, I am poisoned and need the cure. Can you help me?. Fox says: Yes, but you need to answer this riddle. What invention lets you look right through a wall? 
Enter the answer:

>don aj
The fox says: That's wrong, can't give you cure

* * *

>north
(first opening the Castle Door)
The Castle Door is still locked
It seems to be locked.

>east
garage
It is dark in here. In order to see something you must have a flaming torch.

You can see a table (on which is a vase (in which are a nickel key and Rose)) here.

You can see everything. Now you can search for key
You would have to get out of the garage first.

>examine table
It is made of sturdy oak and has a smooth, polished finish. There is a vase with flowers in it.

On the table is a vase (in which are a nickel key and Rose).

* * *

>west
castle
The walls are made of stone, and the floors are polished marble. There are various doors and hallway leading off in different directions.

You can see a Castle Door here.

>north
(first opening the Castle Door)
hallway
The old fridge is a large, white appliance with a dented surface and a handle on the door.

You can also see a Castle Door, Door 1 and Door 2 here.

>door 1
You open Door 1.

kitchen
You are in the castle's kitchen. It is a large, well-equipped space with a fireplace, a fridge, and a table in the center.

>door 2
That's not a verb I recognise.

>east
You can't go that way.

>south
You can't go that way.

>west
You can't go that way.

>north
You can't go that way.

* * *

>south
house
You are now in the old house. It looks like it has been abandoned for some time, but it is still in good repair. There is a male person standing.

It is salesman, who is standing in front of the table, on which are  several gadgets and weaponry. He stares at you intently. You can ask him about the things on the table.

You can also see a table (on which are a sword, a knife and a flaming torch) here.

(From here, you can move to the north and the west.)

>buy flaming troch
I only understood you as far as wanting to buy the flaming torch.

>buy flaming torch
You can buy the the sword, the flaming torch or the knife if you have enough money
You hand over cash, now you have 10 dollars remaining. You take the flaming torch from the salesman.

* * *

>north
(first opening the Castle Door)
hallway
You can see a Castle Door, Door 1 and Door 2 here.

>door 2
You are in Princesses room, but you can see enormous dragon that is very hungry.

    *** Dragon ate you, because you did not bring him any food. GAME OVER ***

Would you like to RESTART, RESTORE a saved game, QUIT or UNDO the last command?

* * *

>undo
hallway
[Previous turn undone.]

>out
castle
You are now in front of castle. In order to get into the castle you need to open the Castle Door.

You can see a Castle Door here.

>north
(first opening the Castle Door)
hallway
You can see a Castle Door, Door 1 and Door 2 here.

* * *

>door 1
You open Door 1.

kitchen
You are in the castle's kitchen. It is a large, well-equipped space with a fireplace, a fridge, and a table in the center. The smell of cooking food fills the air.

The old fridge is a large, white appliance with a dented surface and a handle on the door. It has three cakes inside.

>take cheesecake
You can't see any such thing.

* * *

>out
hallway
You can see a Castle Door, Door 1 and Door 2 here.

>door 2
You are in Princesses room, but you can see enormous dragon that is very hungry.

You open Door 2.

Princesses Room
You entered her room, but there is enormous dragon that is very hungry. Give him poisonus cake that will kill it and save princess

The dragon is a massive, fearsome beast. It has wings that stretch out wide, and its eyes are glowing, fiery orbs. It looks like it is full of hatred and malice, and it seems to relish the thought of causing destruction and chaos.

>feed dragon with cheesecake
You feed the dragon with cheesecake. It is munching it down, grunting happily.

    *** You killed dragon with poisonous cake and saved princess. YOU WON ***

Would you like to RESTART, RESTORE a saved game, QUIT or UNDO the last command?

* * *

>open fridge
That's already open.

>examine fride
You can't see any such thing.

>examine fridge
In the fridge are a dobosica and a chocolate cake.

>eat dobosica
You are poisoned  and have to find a cure if you want to live. The fox has the cure.

(first taking the dobosica)
You eat the dobosica. Not bad.

* * *

>examine fox
Hello smart fox, I am poisoned and need the cure. Can you help me?. Fox says: Yes, but you need to answer this riddle. What invention lets you look right through a wall? 
You see nothing special about the fox.

Enter the answer:

>dont know
Enter the answer:

>a window
The fox says: You are right, here is cure

* * *

>south
house
You are now in the old house. It looks like it has been abandoned for some time, but it is still in good repair. There is a male person standing.

It is salesman, who is standing in front of the table, on which are  several gadgets and weaponry. He stares at you intently. You can ask him about the things on the table.

You can also see a table (on which are a sword, a knife and a flaming torch) here.

(From here, you can move to the north and the west.)

>buy sword
You can buy the the sword, the flaming torch or the knife
You hand over cash, now you have 0 dollars remaining. You take the sword from the salesman.

>buy flaming torch
You can buy the the sword, the flaming torch or the knife
You hand over cash, now you have 10 dollars remaining. You take the flaming torch from the salesman.

>inventory
You are carrying:
  a flaming torch (providing light)
  a sword
  wallet (closed)

* * *

>buy sword
You can buy the the sword, the flaming torch or the knife
You hand over cash, now you have 0 dollars remaining. You take the sword from the salesman.

>inventory
You are carrying:
  a sword
  wallet (closed)

>buy sword
You hand over cash, now you have 20 dollars remaining. You take the sword from the salesman.

Nothing is on sale.

* * *

>south
house
You are now in the old house. It looks like it has been abandoned for some time, but it is still in good repair. There is a male person standing.

It is salesman, who is standing in front of the table, on which are  several gadgets and weaponry. He stares at you intently. You can ask him about the things on the table.

You can also see a table (on which are a sword, a knife and a flaming torch) here.

(From here, you can move to the north and the west.)

>buy the flaming torch
Salesman says: You can buy the the sword, the flaming torch or the knife if you have enough money

I want to buy the flaming torch
You hand over cash, now you have 10 dollars remaining.
You take the flaming torch from the salesman.

>buy sword
You can buy the the sword, the flaming torch or the knife
You hand over cash, now you have 0 dollars remaining. You take the sword from the salesman.

* * *

>buy the flaming torch
Salesman says: You can buy the the sword, the flaming torch or the knife if you have enough money

I want to buy the flaming torch
You hand over cash, now you have 10 dollars remaining.
You take the flaming torch from the salesman.

>buy the flaming torch
You've already bought it.

>buy the sword
Salesman says: You can buy the the sword, the flaming torch or the knife if you have enough money

Sorry, but you do not have enough money to buy the sword

>north
castle
You are now in front of castle. In order to get into the castle you need to open the Castle Door.

You can see a Castle Door here.

(From here, you can move to the north, the south, the east, the west and the inside.)

>east
You can see everything. Now you can search for key
garage
You are in the garage. It is a large, cluttered space with a concrete floor and fluorescent lighting. There is a cabinet along one wall, with a variety of tools and a vase with roses on it.

The smart fox is a small, animal with bright, alert eyes, and a bushy tail. It looks sly and cunning, with a sharp, curious gaze that seems to suggest that it is always thinking.

(From here, you can move to the west.)

>look fox
Do you need something?

You see nothing special about the fox.

>look cabinet
You can't see any such thing.

>examine cabinet
You can't see any such thing.

* * *

>examine the cabinet
You can't see any such thing.

>take cabinet
You can't see any such thing.

>see the cabinet
That's not a verb I recognise.

>look the cabinet
You can't see any such thing.

>examine vase
You can't see any such thing.

>examine the vase
You can't see any such thing.

>west
castle
You are now in front of castle. In order to get into the castle you need to open the Castle Door.

You can see a Castle Door here.

(From here, you can move to the north, the south, the east, the west and the inside.)

>south
house
You are now in the old house. It looks like it has been abandoned for some time, but it is still in good repair. There is a male person standing.

It is salesman, who is standing in front of the table, on which are  several gadgets and weaponry. He stares at you intently. You can ask him about the things on the table.

You can also see a table (on which are a sword and a knife) here.

(From here, you can move to the north.)

* * *

>buy the flaming torch
Salesman says: You can buy the the sword, the flaming torch or the knife if you have enough money

I want to buy the flaming torch
You hand over cash, now you have 10 dollars remaining.
You take the flaming torch from the salesman.

>inventroy
That's not a verb I recognise.

>inventory
You are carrying:
  a flaming torch (providing light)
  wallet (closed)

* * *

>north
castle
The walls are made of stone, and the floors are polished marble. There are various doors and hallway leading off in different directions.

You can see a Castle Door here.

>east
garage
It is dark in here. In order to see something you must have a flaming torch.

You can see a table (on which is a vase (in which are a nickel key and Rose)) here.

You can see everything. Now you can search for key
You would have to get out of the garage first.

* * *

>examine table
It is made of sturdy oak and has a smooth, polished finish. There is a vase with flowers in it.

On the table is a vase (in which are a nickel key and Rose).

>remove the Rose
You aren't wearing Rose.

>remove the Rose from the vase
You picked roses from the vase and can see the nickel key. Keep the key

>inventroy
That's not a verb I recognise.

>inventory
You are carrying:
  a nickel key
  a flaming torch (providing light)
  wallet (closed)

>west
castle
The walls are made of stone, and the floors are polished marble. There are various doors and hallway leading off in different directions.

You can see a Castle Door here.

* * *

>south
house
You are now in the old house. It looks like it has been abandoned for some time, but it is still in good repair. There is a male person standing.

It is salesman, who is standing in front of the table, on which are  several gadgets and weaponry. He stares at you intently. You can ask him about the things on the table.

You can also see a table (on which are a sword, a knife and a flaming torch) here.

(From here, you can move to the north and the west.)

>buy the knife
You can't see any such thing.

>invetory
That's not a verb I recognise.

>inventory
You are carrying:
  wallet (closed)

>buy knife
You can't see any such thing.

* * *

>east
castle
You are now in front of castle. In order to get into the castle you need to open the Castle Door.

You can see a Castle Door here.

(From here, you can move to the north, the south, the east, the west and the inside.)

>aouth
That's not a verb I recognise.

>south
house
You are now in the old house. It looks like it has been abandoned for some time, but it is still in good repair. There is a male person standing.

It is salesman, who is standing in front of the table, on which are  several gadgets and weaponry. He stares at you intently. You can ask him about the things on the table.

You can also see a table (on which are a sword, a knife and a flaming torch) here.

* * *

>take nickel key
Taken.

>wesz
That's not a verb I recognise.

>west
castle
You are now in front of castle. In order to get into the castle you need to open the Castle Door.

You can see a Castle Door here.

* * *

>east
castle
You are now in front of castle. In order to get into the castle you need to open the Castle Door.

You can see a Castle Door here.

(From here, you can move to the north, the south, the east, the west and the inside.)

>east
It is dark in here, I can not see in dark.
The player can not enter garage

>south
house
You are now in the old house. It looks like it has been abandoned for some time, but it is still in good repair. There is a male person standing.

It is salesman, who is standing in front of the table, on which are  several gadgets and weaponry. He stares at you intently. You can ask him about the things on the table.

You can also see a table (on which are a sword, a knife and a flaming torch) here.

* * *

>examine fox
Hello smart fox, I am poisoned and need the cure. Can you help me?. Fox says: Yes, but you need to answer this riddle. What invention lets you look right through a wall? 
You see nothing special about the fox.

Enter the answer:

>hah
The fox is not giving you the cure

>examine fox
*** Fox says: That is wrong answer, no cure for you.
Poison is all over your body, you died: GAME OVER ***

Would you like to RESTART, RESTORE a saved game, QUIT or UNDO the last command?

* * *

>east
You can see everything. Now you can search for key
garage
You are in the garage. It is a large, cluttered space with a concrete floor and fluorescent lighting.

Here is also the smart fox which is a small, animal with bright, alert eyes, and a bushy tail. It looks sly and cunning, with a sharp, curious gaze that seems to suggest that it is always thinking.

You can also see a cabinet and a rug here.

(From here, you can move to the west.)

>look under the rug
You saw a nickel key under the rug. Keep the key

* * *

>take dobosica
Taken.

>eat dobosica
I am full now.

You are poisoned and have to find a cure if you want to live. The fox has the cure.

>out
hallway
You can see a Castle Door, Door 1 and Door 2 here.

(From here, you can move to the south, the inside and the outside.)

* * *

>examine fox
Hello smart fox, I am poisoned and need the cure. Can you help me?.
Fox says:  Yes, but you need to answer this riddle. 
What invention lets you look right through a wall? 
Enter the answer:

>jaj
The fox says: That's wrong, can't give you cure

>examine fox
Hello smart fox, I am poisoned and need the cure. Can you help me?.
Fox says:  Yes, but you need to answer this riddle. 
What invention lets you look right through a wall? 
Eaten poison occurs in 5 minutes from now, you better find cure
Enter the answer:

>a window
The fox says: You are right, here is cure

>east
You can't go that way.

* * *

>west
castle
You are now in front of castle. In order to get into the castle you need to open the Castle Door.

You can see a Castle Door here.

(From here, you can move to the north, the south, the east, the west and the inside.)

>drink cure
You slurp down the cure. Refreshing!

>north
(first opening the Castle Door)
hallway
You can see a Castle Door, Door 1 and Door 2 here.

(From here, you can move to the south, the inside and the outside.)

* * *

>out
hallway
You can see a Castle Door, Door 1 and Door 2 here.

(From here, you can move to the south, the inside and the outside.)

>inventory
You are carrying:
  a chocolate cake
  a nickel key
  a flaming torch (providing light)

>door 2
Princesses Room
You entered her room, but there is enormous dragon that is very hungry. Feed it with a poisonus cake and save princess

The dragon is a massive, fearsome beast. It has wings that stretch out wide, and its eyes are glowing, fiery orbs. It looks like it is full of hatred and malice, and it seems to relish the thought of causing destruction and chaos.

The princess is standing in the back of the room, she is looking scared.

(From here, you can move to the outside.)

* * *

>take wallet
Amazing, you have money. You can buy items in the old house.

>open wallet
You open the wallet, revealing d dollar bills.

* * *

>take wallet
Amazing, you have money. You can buy items in the old house.

>west
You can't go that way.

It feels as though you haven't eaten in days. Weeks, almost.

>east
castle
You are now in front of castle. In order to get into the castle you need to open the Castle Door.

You can see a Castle Door here.

(From here, you can move to the north, the south, the east, the west and the inside.)

It feels as though you haven't eaten in days. Weeks, almost.

>south
house
You are now in the old house. It looks like it has been abandoned for some time, but it is still in good repair. There is a male person standing.

It is salesman, who is standing in front of the table, on which are  several gadgets and weaponry. He stares at you intently. You can ask him about the things on the table.

You can also see a table (on which are a sword, a knife and a flaming torch) here.

(From here, you can move to the north and the west.)

It feels as though you haven't eaten in days. Weeks, almost.

>buy flaming torch
Salesman says: You can buy the the sword, the flaming torch or the knife if you have enough money

I want to buy the flaming torch

You hand over cash, now you have 10 dollars remaining.
You take the flaming torch from the salesman.

Gosh, you're starving.

>north
castle
You are now in front of castle. In order to get into the castle you need to open the Castle Door.

You can see a Castle Door here.

(From here, you can move to the north, the south, the east, the west and the inside.)

It feels as though you haven't eaten in days. Weeks, almost.

>east
You can see everything. Now you can search for key
garage
You are in the garage. It is a large, cluttered space with a concrete floor and fluorescent lighting.

Here is also the smart fox which is a small, animal with bright, alert eyes, and a bushy tail. It looks sly and cunning, with a sharp, curious gaze that seems to suggest that it is always thinking.

You can also see a cabinet and a rug here.

(From here, you can move to the west.)

It feels as though you haven't eaten in days. Weeks, almost.

>find nickel key
That's not a verb I recognise.

>look nickel key
You see nothing special about the nickel key.

>examine nickel key
You see nothing special about the nickel key.

>look inside the vase
In the vase are a nickel key and Rose.

>remove Rose from the vase
You picked roses from the vase and can see the nickel key. Keep the key

* * *

>east
You can see everything. Now you can search for key
garage
You are in the garage. It is a large, cluttered space with a concrete floor and fluorescent lighting.

Here is also the smart fox which is a small, animal with bright, alert eyes, and a bushy tail. It looks sly and cunning, with a sharp, curious gaze that seems to suggest that it is always thinking.

You can also see a cabinet and a rug here.

(From here, you can move to the west.)

It feels as though you haven't eaten in days. Weeks, almost.

>look under the rug
You saw a nickel key under the rug. Keep the key
Gosh, you're starving.

>west
castle
You are now in front of castle. In order to get into the castle you need to open the Castle Door.

You can see a Castle Door here.

(From here, you can move to the north, the south, the east, the west and the inside.)

Gosh, you're starving.

>north
(first opening the Castle Door)
hallway
You can see a Castle Door, Door 1 and Door 2 here.

(From here, you can move to the south, the inside and the outside.)

It feels as though you haven't eaten in days. Weeks, almost.

>door 1
You open Door 1.

kitchen
You are in the castle's kitchen. It is a large, well-equipped space with a fireplace, a fridge, and a table in the center. The smell of cooking food fills the air.

The old fridge is a large, white appliance with a dented surface and a handle on the door. It has three cakes inside.

(From here, you can move to the outside.)

Gosh, you're starving.

>open fridge
I am very hungry. I want to eat dobosica
It feels as though you haven't eaten in days. Weeks, almost.

>eat dobosica
(first taking the dobosica)
You're carrying too many things already.

Gosh, you're starving.

>drop wallet
Dropped.

Gosh, you're starving.

>eat cheescake
You can't see any such thing.

>eat cheesecake
(first taking the cheesecake)
I am full now.

You eat the cheesecake. Not bad.

>north
You can't go that way.

>out
hallway
You can see a Castle Door, Door 1 and Door 2 here.

(From here, you can move to the south, the inside and the outside.)

>out
castle
You are now in front of castle. In order to get into the castle you need to open the Castle Door.

You can see a Castle Door here.

(From here, you can move to the north, the south, the east, the west and the inside.)

Gosh, you're starving.

>inside
hallway
You can see a Castle Door, Door 1 and Door 2 here.

(From here, you can move to the south, the inside and the outside.)

Gosh, you're starving.

>door 1
kitchen
You are in the castle's kitchen. It is a large, well-equipped space with a fireplace, a fridge, and a table in the center. The smell of cooking food fills the air.

The old fridge is a large, white appliance with a dented surface and a handle on the door. It has three cakes inside.

You can also see a wallet (closed) here.

(From here, you can move to the outside.)

It feels as though you haven't eaten in days. Weeks, almost.

    *** You have starved ***

Would you like to RESTART, RESTORE a saved game, QUIT or UNDO the last command?

>undo
hallway
[Previous turn undone.]

>door 1
kitchen
You are in the castle's kitchen. It is a large, well-equipped space with a fireplace, a fridge, and a table in the center. The smell of cooking food fills the air.

The old fridge is a large, white appliance with a dented surface and a handle on the door. It has three cakes inside.

You can also see a wallet (closed) here.

(From here, you can move to the outside.)

It feels as though you haven't eaten in days. Weeks, almost.

    *** You have starved ***

Would you like to RESTART, RESTORE a saved game, QUIT or UNDO the last command?

>restart
There was once a young man named Jack who lived in a small village. Jack was often the subject of ridicule and laughter because he was different from everyone else. He was clumsy and awkward, and he often stumbled and fell when he walked. Despite this, Jack had a kind and generous heart, and he always tried to help others whenever he could. One day, a rumor spread through the village that a beautiful princess had been captured by a dragon and locked away in a castle. The villagers were afraid to try and rescue the princess, but Jack knew he had to do something. He knew he was no match for the dragon, but he also knew that he couldn't just stand by and do nothing. Despite the laughter and ridicule of the other villagers, Jack set out on a journey to rescue the princess. You are Jack. You are in forest now.

Igra
An Interactive Fiction by Ivona Kostic
Release 1 / Serial number 230107 / Inform 7 v10.1.2 / D

forest
You are standing in a dense forest. The trees are tall and their branches form a canopy overhead, blocking out most of the sunlight. There is a faint path winding through the underbrush, leading east and west.

(From here, you can move to the east.)

>east
You follow the east path deeper into the forest and got to the old house.

house
You are now in the old house. It looks like it has been abandoned for some time, but it is still in good repair. There is a male person standing.

It is salesman, who is standing in front of the table, on which are  several gadgets and weaponry. He stares at you intently. You can ask him about the things on the table.

You can also see a table (on which are a sword, a knife and a flaming torch) here.

(From here, you can move to the north and the west.)

Gosh, you're starving.

>north
castle
You are now in front of castle. In order to get into the castle you need to open the Castle Door.

You can see a Castle Door here.

(From here, you can move to the north, the south, the east, the west and the inside.)

It feels as though you haven't eaten in days. Weeks, almost.

>west
garden
You are now in the garden.

Here is a huge box made of wood with a hinged lid. It is well-worn, with scratches and dents on its surface. It looks like it has been used for storing things for a long time. You can open it and see what is inside.

(From here, you can move to the east.)

It feels as though you haven't eaten in days. Weeks, almost.

>open box
You open the box, revealing bag.

Gosh, you're starving.

>open bag
You open bag, revealing a wallet.

Gosh, you're starving.

>take wallet
Amazing, you have money. You can buy items in the old house.

It feels as though you haven't eaten in days. Weeks, almost.

>east
castle
You are now in front of castle. In order to get into the castle you need to open the Castle Door.

You can see a Castle Door here.

(From here, you can move to the north, the south, the east, the west and the inside.)

It feels as though you haven't eaten in days. Weeks, almost.

* * *

>north
castle
You are now in front of castle. In order to get into the castle you need to open the Castle Door.

You can see a Castle Door here.

(From here, you can move to the north, the south, the east, the west and the inside.)

It feels as though you haven't eaten in days. Weeks, almost.

>east
You can see everything. Now you can search for key
garage
You are in the garage. It is a large, cluttered space with a concrete floor and fluorescent lighting.

Here is also the smart fox which is a small, animal with bright, alert eyes, and a bushy tail. It looks sly and cunning, with a sharp, curious gaze that seems to suggest that it is always thinking.

You can also see a cabinet and a rug here.

(From here, you can move to the west.)

Gosh, you're starving.

>look under rug
You saw a nickel key under the rug. Keep the key
Gosh, you're starving.

>west
castle
You are now in front of castle. In order to get into the castle you need to open the Castle Door.

You can see a Castle Door here.

(From here, you can move to the north, the south, the east, the west and the inside.)

Gosh, you're starving.

>north
(first opening the Castle Door)
hallway
You can see a Castle Door, Door 1 and Door 2 here.

(From here, you can move to the south, the inside and the outside.)

Gosh, you're starving.

>door 1
You open Door 1.

kitchen
You are in the castle's kitchen. It is a large, well-equipped space with a fireplace, a fridge, and a table in the center. The smell of cooking food fills the air.

The old fridge is a large, white appliance with a dented surface and a handle on the door. It has three cakes inside.

(From here, you can move to the outside.)

It feels as though you haven't eaten in days. Weeks, almost.

>open frdige
You can't see any such thing.

>open fridige
You can't see any such thing.

>open fridge
I am very hungry. I want to eat dobosica
It feels as though you haven't eaten in days. Weeks, almost.

* * *

>eat dobosica
(first taking the dobosica)
You're carrying too many things already.

Gosh, you're starving.

>drop wallet
Dropped.

It feels as though you haven't eaten in days. Weeks, almost.

>take dobosica
Taken.

Gosh, you're starving.

>eat dobosica
I am full now.

You are poisoned and have to find a cure if you want to live. The fox has the cure.

* * *

>out
hallway
You can see a Castle Door, Door 1 and Door 2 here.

(From here, you can move to the south, the inside and the outside.)

>out
castle
You are now in front of castle. In order to get into the castle you need to open the Castle Door.

You can see a Castle Door here.

(From here, you can move to the north, the south, the east, the west and the inside.)

It feels as though you haven't eaten in days. Weeks, almost.

>east
You can see everything. Now you can search for key
garage
You are in the garage. It is a large, cluttered space with a concrete floor and fluorescent lighting.

Here is also the smart fox which is a small, animal with bright, alert eyes, and a bushy tail. It looks sly and cunning, with a sharp, curious gaze that seems to suggest that it is always thinking.

You can also see a cabinet and a rug here.

(From here, you can move to the west.)

Gosh, you're starving.

>examine fox
Hello smart fox, I am poisoned and need the cure. Can you help me?.
Fox says:  Yes, but you need to answer this riddle. 
What invention lets you look right through a wall? 
It feels as though you haven't eaten in days. Weeks, almost.

    *** You have starved ***

Would you like to RESTART, RESTORE a saved game, QUIT or UNDO the last command?

* * *

>open bag
You open bag, revealing a wallet.

>take wallez
You can't see any such thing.

>take wallet
Amazing, you have money. You can buy items in the old house.

* * *

>eat dobosica
(first taking the dobosica)
I am full now.

You are poisoned and have to find a cure if you want to live. The fox has the cure.

>out
hallway
You can see a Castle Door, Door 1 and Door 2 here.

(From here, you can move to the south, the inside and the outside.)

Eaten poison occurs in 1 minutes from now, you better find cure

>out
castle
You are now in front of castle. In order to get into the castle you need to open the Castle Door.

You can see a Castle Door here.

(From here, you can move to the north, the south, the east, the west and the inside.)

    *** You have been posioned ***

Would you like to RESTART, RESTORE a saved game, QUIT or UNDO the last command?

* * *

>open bag
You open bag, revealing a wallet.

>teka wallet
That's not a verb I recognise.

>take wallet
Amazing, you have money. You can buy items in the old house.

* * *

>north
You can't go that way.

>east
castle
You are now in front of castle. In order to get into the castle you need to open the Castle Door.

You can see a Castle Door here.

* * *

>east
You can see everything. Now you can search for key
garage
You are in the garage. It is a large, cluttered space with a concrete floor and fluorescent lighting. There is a cabinet along one wall, with a variety of tools and a vase with roses on it.

The smart fox is a small, animal with bright, alert eyes, and a bushy tail. It looks sly and cunning, with a sharp, curious gaze that seems to suggest that it is always thinking.

You can also see a cabinet (on which is a vase (in which are a nickel key and a roses)) here.

>take nickel ke
I only understood you as far as wanting to take the nickel key.

>take nickel key
Taken.

* * *

>examine fox
Hello smart fox, I am poisoned and need the cure. Can you help me?. Fox says: Yes, but you need to answer this riddle. What invention lets you look right through a wall? 
Enter the answer:

>a widnow
The fox says: That's wrong, can't give you cure

>examine fox
Hello smart fox, I am poisoned and need the cure. Can you help me?. Fox says: Yes, but you need to answer this riddle. What invention lets you look right through a wall? 
Enter the answer:

* * *

>a window
The fox says: You are right, here is cure

>drink a cure
You slurp down the cure. Refreshing!

There's nothing suitable to drink here.

>inventory
You are carrying:
  a cure
  a nickel key
  a flaming torch (providing light)
  a wallet (closed)

* * *

>open bah
You can't see any such thing.

>open bag
You open bag, revealing a wallet.

* * *

>door 1
You open Door 1.

kitchen
You are in the castle's kitchen. It is a large, well-equipped space with a fireplace, a fridge, and a table in the center. The smell of cooking food fills the air.

The old fridge is a large, white appliance with a dented surface and a handle on the door. It has three cakes inside.

>open fridgw
You can't see any such thing.

>open fridge
I am very hungry. I want to eat dobosica

* * *

>jaj
That's not a verb I recognise.

Enter the answer:

>a window
The fox says: You are right, here is cure

>jaj
That's not a verb I recognise.

* * *

>open box
You open the box, revealing bag.

>take baf
You can't see any such thing.

>open bag
You open bag, revealing a wallet.

Gosh, you're starving.

>take wallet
Amazing, you have money. You can buy items in the old house.

Gosh, you're starving.

>east
castle
You are now in front of castle. In order to get into the castle you need to open the Castle Door.

You can see a Castle Door here.

(From here, you can move to the north, the south, the east, the west and the inside.)

It feels as though you haven't eaten in days. Weeks, almost.

* * *

>buy flaming torch
Salesman says: You can buy the the sword, the flaming torch or the knife if you have enough money

I want to buy the flaming torch

You hand over cash, now you have 10 dollars remaining.
You take the flaming torch from the salesman.

Gosh, you're starving.

>north
castle
You are now in front of castle. In order to get into the castle you need to open the Castle Door.

You can see a Castle Door here.

(From here, you can move to the north, the south, the east, the west and the inside.)

Gosh, you're starving.

>east
You can see everything. Now you can search for key
garage
You are in the garage. It is a large, cluttered space with a concrete floor and fluorescent lighting.

Here is also the smart fox which is a small, animal with bright, alert eyes, and a bushy tail. It looks sly and cunning, with a sharp, curious gaze that seems to suggest that it is always thinking.

You can also see a cabinet and a rug here.

(From here, you can move to the west.)

It feels as though you haven't eaten in days. Weeks, almost.

>look under rug
You saw a nickel key under the rug. Keep the key
It feels as though you haven't eaten in days. Weeks, almost.

>west
castle
You are now in front of castle. In order to get into the castle you need to open the Castle Door.

You can see a Castle Door here.

(From here, you can move to the north, the south, the east, the west and the inside.)

Gosh, you're starving.

* * *

>north
(first opening the Castle Door)
hallway
You can see a Castle Door, Door 1 and Door 2 here.

(From here, you can move to the south, the inside and the outside.)

Gosh, you're starving.

>door 1
You open Door 1.

kitchen
You are in the castle's kitchen. It is a large, well-equipped space with a fireplace, a fridge, and a table in the center. The smell of cooking food fills the air.

The old fridge is a large, white appliance with a dented surface and a handle on the door. It has three cakes inside.

(From here, you can move to the outside.)

Gosh, you're starving.

>open fridge
I am very hungry. I want to eat dobosica
Gosh, you're starving.

>eat dobosica
(first taking the dobosica)
You're carrying too many things already.

Gosh, you're starving.

* * *

>drop wallet
Dropped.

It feels as though you haven't eaten in days. Weeks, almost.

>eat dobosica
(first taking the dobosica)
I am full now.

You are poisoned and have to find a cure if you want to live. The fox has the cure.

* * *

>east
You can see everything. Now you can search for key
garage
You are in the garage. It is a large, cluttered space with a concrete floor and fluorescent lighting.

Here is also the smart fox which is a small, animal with bright, alert eyes, and a bushy tail. It looks sly and cunning, with a sharp, curious gaze that seems to suggest that it is always thinking.

You can also see a cabinet and a rug here.

(From here, you can move to the west.)

>examine fox
Hello smart fox, I am poisoned and need the cure. Can you help me?.
Fox says:  Yes, but you need to answer this riddle. 
What invention lets you look right through a wall? 
A starvation occurs in three minutes from now
Enter the answer:

>dont know
The fox says: That's wrong, can't give you cure

>examine fox
Hello smart fox, I am poisoned and need the cure. Can you help me?.
Fox says:  Yes, but you need to answer this riddle. 
What invention lets you look right through a wall? 
Gosh, you're starving.

Enter the answer:

>a window
The fox says: You are right, here is cure

>drink cure
You slurp down the cure. Refreshing!

It feels as though you haven't eaten in days. Weeks, almost.

* * *

>west
garden
You are now in the garden.

Here is a huge box made of wood with a hinged lid. It is well-worn, with scratches and dents on its surface. It looks like it has been used for storing things for a long time. You can open it and see what is inside.

(From here, you can move to the east.)

>open boy
You can't see any such thing.

* * *

>out
hallway
You can see a Castle Door, Door 1 and Door 2 here.

>our
That's not a verb I recognise.

>out
castle
You are now in front of castle. In order to get into the castle you need to open the Castle Door.

You can see a Castle Door here.

* * *

>examine fox
Hello smart fox, I am poisoned and need the cure. Can you help me?. Fox says: Yes, but you need to answer this riddle. What invention lets you look right through a wall? 
You see nothing special about the fox.

Enter the answer:

>ahah
The fox says: That's wrong, can't give you cure

>gotovo
That's not a verb I recognise.

>sa
That's not a verb I recognise.

>examine fox
*** Fox says: That is wrong answer, no cure for you.
Poison is all over your body, you died: GAME OVER ***

Would you like to RESTART, RESTORE a saved game, QUIT or UNDO the last command?

>undo
garage
[Previous turn undone.]

>look fox
*** Fox says: That is wrong answer, no cure for you.
Poison is all over your body, you died: GAME OVER ***

Would you like to RESTART, RESTORE a saved game, QUIT or UNDO the last command?

* * *

>north
castle
You are now in front of castle. In order to get into the castle you need to open the Castle Door.

You can see a Castle Door here.

(From here, you can move to the north, the south, the east, the west and the inside.)

>wesz
That's not a verb I recognise.

>west
garden
You are now in the garden.

Here is a huge box made of wood with a hinged lid. It is well-worn, with scratches and dents on its surface. It looks like it has been used for storing things for a long time. You can open it and see what is inside.

* * *

>north
castle
You are now in front of castle. In order to get into the castle you need to open the Castle Door.

You can see a Castle Door here.

(From here, you can move to the north, the south, the east, the west and the inside.)

>wets
That's not a verb I recognise.

>west
garden
You are now in the garden.

Here is a huge box made of wood with a hinged lid. It is well-worn, with scratches and dents on its surface. It looks like it has been used for storing things for a long time. You can open it and see what is inside.

* * *

>door 1
You open Door 1.

kitchen
You are in the castle's kitchen. It is a large, well-equipped space with a fireplace, a fridge, and a table in the center. The smell of cooking food fills the air.

The old fridge is a large, white appliance with a dented surface and a handle on the door. It has three cakes inside.

>eat dobosica
You can't see any such thing.

* * *

>jaj
That's not a verb I recognise.

>drink cuređ
You can't see any such thing.

>drink cure
There's nothing suitable to drink here.

>inventory
You are carrying:
  a cure
  a nickel key
  a flaming torch (providing light)
  a wallet (closed)

>drink the cure
There's nothing suitable to drink here.

* * *

>drink a cure
There's nothing suitable to drink here.

>drink cure
There's nothing suitable to drink here.

>examine fox
Hello smart fox, I am poisoned and need the cure. Can you help me?. Fox says: Yes, but you need to answer this riddle. What invention lets you look right through a wall? 
Enter the answer:

>aj
The fox says: That's wrong, can't give you cure

* * *

>east
You follow the east path deeper into the forest and got to the old house.

house
You are now in the old house. It looks like it has been abandoned for some time, but it is still in good repair. There is a male person standing.

It is salesman, who is standing in front of the table, on which are  several gadgets and weaponry. He stares at you intently. You can ask him about the things on the table.

You can also see a table (on which are a sword, a knife and a flaming torch) here.

(From here, you can move to the north and the west.)

>the East Path
That's not a verb I recognise.

>east
Which do you mean, the east or the East Path?

>East Path
You follow the east path deeper into the forest.

You can't go that way.

>East Path
You follow the east path deeper into the forest.

You can't go that way.

>West Path
You can't go that way.

>east
Which do you mean, the east or the East Path?

>west
Which do you mean, the west or the West Path?

>West Path
I only understood you as far as wanting to (go) West Path.

>go West Path
You can't go that way.

>West Path
You can't go that way.

* * *

>the East Path
That's not a verb I recognise.

>the east
I only understood you as far as wanting to (go) The West Path.

>no
That was a rhetorical question.

>west
Which do you mean, the west or The West Path?

>The West Path
You can't go that way.

* * *

>east
You follow the east path deeper into the forest and got to the old house.

house
You are now in the old house. It looks like it has been abandoned for some time, but it is still in good repair. There is a male person standing.

It is salesman, who is standing in front of the table, on which are  several gadgets and weaponry. He stares at you intently. You can ask him about the things on the table.

You can also see a table (on which are a sword, a knife and a flaming torch) here.

(From here, you can move to the north and the west.)

>west
You follow the west path deeper into the forest and got into the house.

house
You are now in the old house. It looks like it has been abandoned for some time, but it is still in good repair. There is a male person.

A salesman is standing in front of the table, staring at you intently.

You can also see a table (on which are a sword, a knife and a flaming torch) here.

You would have to get out of the house first.

>east
You cannot go east from here.

You can't go that way.

* * *

>west
You follow the west path deeper into the forest and got into the house.

house
You are now in the old house. It looks like it has been abandoned for some time, but it is still in good repair. There is a male person.

A salesman is standing in front of the table, staring at you intently.

You can also see a table (on which are a sword, a knife and a flaming torch) here.

You would have to get out of the house first.

>north
castle
The walls are made of stone, and the floors are polished marble. There are various doors and hallway leading off in different directions.

You can see a Castle Door here.

>open castle door
It seems to be locked.

>east
garage

>west
castle
The walls are made of stone, and the floors are polished marble. There are various doors and hallway leading off in different directions.

You can see a Castle Door here.

>west
(first opening the Castle Door)
It seems to be locked.

>north
hallway
You can see Door 1 and Door 2 here.

* * *

>east path
You can't go that way.

>the east path
That's not a verb I recognise.

>go the east path
You can't go that way.

>east
Which do you mean, the east or the East Path?

>the East PAth
That's not a verb I recognise.

>the East Path
That's not a verb I recognise.

* * *

>eat food
You can't see any such thing.

>east
You follow the east path deeper into the forest and got to the old house.

house
You are now in the old house. It looks like it has been abandoned for some time, but it is still in good repair. There is a male person standing.

It is salesman, who is standing in front of the table, on which are  several gadgets and weaponry. He stares at you intently. You can ask him about the things on the table.

You can also see a table (on which are a sword, a knife and a flaming torch) here.

(From here, you can move to the north and the west.)

* * *

>east
You can see everything. Now you can search for key
garage
You are in the garage. It is a large, cluttered space with a concrete floor and fluorescent lighting.

Here is also the smart fox which is a small, animal with bright, alert eyes, and a bushy tail. It looks sly and cunning, with a sharp, curious gaze that seems to suggest that it is always thinking.

You can also see a cabinet and a rug here.

(From here, you can move to the west.)

>examine fox
Hello smart fox, I am poisoned and need the cure. Can you help me?.
Fox says:  Yes, but you need to answer this riddle. 
What invention lets you look right through a wall? 

    *** You have starved ***

Would you like to RESTART, RESTORE a saved game, QUIT or UNDO the last command?

* * *

>go The West Path
You can't go that way.

>The West Path
That's not a verb I recognise.

>west
Which do you mean, the west or the West Path?

>the West Path
That's not a verb I recognise.

>west
Which do you mean, the west or the West Path?

>the west
That's not a verb I recognise.

>west
Which do you mean, the west or the West Path?

* * *

>go east
You can't go that way.

>e
You can't go that way.

* * *

>go east
You can't go that way.

>go the East Path
You can't go that way.

>east
Which do you mean, the east or the East Path?

>the East Path
I only understood you as far as wanting to (go) The West Path.

>The West Path
You can't go that way.

>go the West Path
You can't go that way.

>west
Which do you mean, the west or The West Path?

>the West Path
You can't go that way.

* * *

>go east direction
Which do you mean, the east or the East Path?

>the east path
You can't go that way.

>go east path
You can't go that way.

>the the east path
That's not a verb I recognise.

* * *

>go north
Which do you mean, the north or the North Path?

>the North Path
You can't go that way.

>go the north path
You can't go that way.

>go The North Path
You can't go that way.

>go north
Which do you mean, the north or the North Path?

>the north
Which do you mean, the north or the North Path?

>the North Path
You can't go that way.

>east
Which do you mean, the east or the East Path?

>The East Path
That's not a verb I recognise.

>go to The East Path
You can't see any such thing.

>go The East Path
You can't go that way.

* * *

>go the east path
You can't go that way.

>go the East Path
You can't go that way.

>the East Path
That's not a verb I recognise.

* * *

>go west
Which do you mean, the west or the West Path?

>West Path
You follow the west path out of the forest and into the clearing.

house
You would have to get out of the house first.

>east
Which do you mean, the east or the East Path?

* * *

>inventory
You are carrying nothing.

* * *

>north
You can't go that way.

>east
You follow the east path deeper into the forest and got to the old house.

house
You are now in the old house. It looks like it has been abandoned for some time, but it is still in good repair. There is a male person standing.

It is salesman, who is standing in front of the table, on which are  several gadgets and weaponry. He stares at you intently. You can ask him about the things on the table.

You can also see a table (on which are a sword, a knife and a flaming torch) here.

(From here, you can move to the north and the west.)

* * *

>door 1
kitchen
You are in the castle's kitchen. It is a large, well-equipped space with a fireplace, a fridge, and a table in the center. The smell of cooking food fills the air.

The old fridge is a large, white appliance with a dented surface and a handle on the door. It has three cakes inside.

(From here, you can move to the outside.)

>drop cheesecake
Dropped.

>take dobosica
You're carrying too many things already.

>inventory
You are carrying:
  a nickel key
  a flaming torch (providing light)
  a wallet (closed)

* * *

>north
(first opening the Castle Door)
The Castle Door is locked.
Search for the key in the garage.

>south
house
You are now in the old house. It looks like it has been abandoned for some time, but it is still in good repair. There is a male person standing.

It is salesman, who is standing in front of the table, on which are  several gadgets and weaponry. He stares at you intently. You can ask him about the things on the table.

You can also see a table (on which are a sword, a knife and a flaming torch) here.

(From here, you can move to the north and the west.)

* * *

>examine fox
Fox says: Do you need something?
You see nothing special about the fox.

>west
castle
You are now in front of castle. In order to get into the castle you need to open the Castle Door.

You can see a Castle Door here.

(From here, you can move to the north, the south, the east, the west and the inside.)

>east
You can see everything. Now you can search for key
garage
You are in the garage. It is a large, cluttered space with a concrete floor and fluorescent lighting.

Here is also the smart fox which is a small, animal with bright, alert eyes, and a bushy tail. It looks sly and cunning, with a sharp, curious gaze that seems to suggest that it is always thinking.

You can also see a cabinet and a rug here.

(From here, you can move to the west.)

* * *

>look under rug
You saw a nickel key under the rug. Keep the key

>north
You can't go that way.

>west
castle
You are now in front of castle. In order to get into the castle you need to open the Castle Door.

You can see a Castle Door here.

(From here, you can move to the north, the south, the east, the west and the inside.)

* * *

>east
You follow the east path deeper into the forest and got to the old house.

house
You are now in the old house. It looks like it has been abandoned for some time, but it is still in good repair. There is a male person standing.

It is salesman, who is standing in front of the table, on which are  several gadgets and weaponry. He stares at you intently. You can ask him about the things on the table.

You can also see a table (on which are a sword, a knife and a flaming torch) here.

(From here, you can move to the north and the west.)

>west
You follow the west path out of the forest and into the house.

house
You are now in the old house. It looks like it has been abandoned for some time, but it is still in good repair. There is a fireplace in one corner and a few old pieces of furniture scattered around the room.

A salesman is standing in front of the table, staring at you intently.

You can also see a table (on which are a sword, a knife and a flaming torch) here.

You would have to get out of the house first.

* * *

>south
You can't go that way.

>east
You follow the east path deeper into the forest and got to the old house.

house
You are now in the old house. It looks like it has been abandoned for some time, but it is still in good repair. There is a male person standing.

It is salesman, who is standing in front of the table, on which are  several gadgets and weaponry. He stares at you intently. You can ask him about the things on the table.

You can also see a table (on which are a sword, a knife and a flaming torch) here.

>north
castle
You are now in front of castle. In order to get into the castle you need to open the Castle Door.

You can see a Castle Door here.

* * *

>east
castle
The walls are made of stone, and the floors are polished marble. There are various doors and hallway leading off in different directions.

You can see a Castle Door here.

>east
garage
It is dark in here. In order to see something you must have a flaming torch.

You can see a table (on which is a vase (in which are a nickel key and Rose)) here.

You can see everything. Now you can search for key
You would have to get out of the garage first.

>remove Rose from the vase
You picked roses from the vase and can see the nickel key. Keep the key

* * *

>examine fridge
In the fridge are a cheescake, a dobosica and a chocolate cake.

I am very hungry. I want to eat dobosica

>eat dobosica
You have to find a cure if you want to live. The fox has the cure.

(first taking the dobosica)
You eat the dobosica. Not bad.

* * *

>north
You can't go that way.

>west
You can't go that way.

>east
castle
You are now in front of castle. In order to get into the castle you need to open the Castle Door.

You can see a Castle Door here.

* * *

>east
You can see everything. Now you can search for key
garage
You are in the garage. It is a large, cluttered space with a concrete floor and fluorescent lighting. There is a cabinet along one wall, with a variety of tools and a vase with roses on it.

The smart fox is a small, animal with bright, alert eyes, and a bushy tail. It looks sly and cunning, with a sharp, curious gaze that seems to suggest that it is always thinking.

You can also see a cabinet (on which is a vase (in which are a nickel key and a roses)) here.

>west
castle
You are now in front of castle. In order to get into the castle you need to open the Castle Door.

You can see a Castle Door here.

>east
You can see everything. Now you can search for key
garage
You are in the garage. It is a large, cluttered space with a concrete floor and fluorescent lighting. There is a cabinet along one wall, with a variety of tools and a vase with roses on it.

The smart fox is a small, animal with bright, alert eyes, and a bushy tail. It looks sly and cunning, with a sharp, curious gaze that seems to suggest that it is always thinking.

You can also see a cabinet (on which is a vase (in which are a nickel key and a roses)) here.

* * *

>take nickel key
Taken.

>east
You can't go that way.

>north
You can't go that way.

* * *

>ajj
That's not a verb I recognise.

>examine fox
*** Fox says: That is wrong answer, no cure for you.
Poison is all over your body, you died: GAME OVER ***

Would you like to RESTART, RESTORE a saved game, QUIT or UNDO the last command?

* * *

>to go east
That's not a verb I recognise.

>go east
Which do you mean, the east or the East Path?

>east
Which do you mean, the east or the East Path?

>the East Path
You can't go that way.

>west
Which do you mean, the west or the West Path?

>the West PAth
That's not a verb I recognise.

>the West Path
That's not a verb I recognise.

>go the west path
You can't go that way.

* * *

>west
You follow the west path out of the forest

    *** After finding a way out, you were too scared to go back in the forest. ***

Would you like to RESTART, RESTORE a saved game, QUIT or UNDO the last command?

>ask salesman about the sword
It costs 20 euros

>buy sword
You do not have money, so you can not buy the flaming torch

* * *

>west
You follow the west path out of the forest

    *** After finding a way out, you were too scared to go back in the forest. ***

Would you like to RESTART, RESTORE a saved game, QUIT or UNDO the last command?

>buy
What do you want to buy?

>a flaming torch
Nothing is on sale.

>the flaming torch
That's not a verb I recognise.

>buy
What do you want to buy?

>the sword
Nothing is on sale.

>talk to salesman
That's not a verb I recognise.

>talk to the salesman
That's not a verb I recognise.

>examine table
The table is made of sturdy oak and has a smooth, polished finish. There are various weaponry and gadgets on the desk.

On the table are a sword, a knife and a flaming torch.

>ask the salesman
What do you want to ask the Salesman for?

>the flaming torch
(the Salesman first taking the flaming torch)
The Salesman has better things to do.

>how much the sword costs
That's not a verb I recognise.

>ask the salesman how much the sword costs
I didn't understand that sentence.

>ask the salesman
What do you want to ask the Salesman for?

>how much the sword costs
You can't see any such thing.

>the sword
That's not a verb I recognise.

>ask the salesman about the sword
It costs 20 euros

>buy the sword
Nothing is on sale.

* * *

>west
You follow the west path out of the forest

    *** After finding a way out, you were too scared to go back in the forest. ***

Would you like to RESTART, RESTORE a saved game, QUIT or UNDO the last command?

>buy the sword
You do not have money, so you can not buy that thing

>north
castle
The walls are made of stone, and the floors are polished marble. There are various doors and hallway leading off in different directions.

You can see a Castle Door here.

* * *

>east
I can not see in dark. The player can not enter garage

>west
garden
The hudge box is made of wood and has a hinged lid. It is well-worn, with scratches and dents on its surface. It looks like it has been used for storing things for a long time.

>examine
(the box)
You see nothing special about the box.

>examine box
You see nothing special about the box.

>look
garden
The hudge box is made of wood and has a hinged lid. It is well-worn, with scratches and dents on its surface. It looks like it has been used for storing things for a long time.

>open box
You open the box, revealing bag.

* * *

>open bag
You open bag, revealing wallet.

>open walle
You can't see any such thing.

>open wallet
You open wallet, revealing a money.

>take money
Amazing, you found money. You can buy items in the old house.

>inventory
You are carrying:
  a money

>south
You can't go that way.

* * *

>east
castle
The walls are made of stone, and the floors are polished marble. There are various doors and hallway leading off in different directions.

You can see a Castle Door here.

>south
house
You are now in the old house. It looks like it has been abandoned for some time, but it is still in good repair. There is a male person.

A salesman is standing in front of the table, staring at you intently.

You can also see a table (on which are a sword, a knife and a flaming torch) here.

>buy the flaming torch
Thanks, have a nice day

>north
castle
The walls are made of stone, and the floors are polished marble. There are various doors and hallway leading off in different directions.

You can see a Castle Door here.

>east
You can see everything. Now I can search for key
garage
You can not see anything. In order to see something you must have a flaming torch.

You would have to get out of the garage first.

>out
But you aren't in anything at the moment.

>west
castle
The walls are made of stone, and the floors are polished marble. There are various doors and hallway leading off in different directions.

You can see a Castle Door here.

>east
You can see everything. Now I can search for key
garage
You can not see anything. In order to see something you must have a flaming torch.

You would have to get out of the garage first.

* * *

>west
You follow the west path out of the forest

    *** After finding a way out, you were too scared to go back in the forest. ***

Would you like to RESTART, RESTORE a saved game, QUIT or UNDO the last command?

>castle door
That's not a verb I recognise.

>west
You can't go that way.

>east
You can't go that way.

>examine castle door
You see nothing special about the Castle Door.

>go in castle door
(first opening the Castle Door)
It seems to be locked.

* * *

>west
You follow the west path out of the forest

    *** After finding a way out, you were too scared to go back in the forest. ***

Would you like to RESTART, RESTORE a saved game, QUIT or UNDO the last command?

>east
You follow the east path deeper into the forest and got into the house.

house
You are now in the old house. It looks like it has been abandoned for some time, but it is still in good repair. There is a male person standing.

It is salesman, who is standing with a briefcase in his hand which is filled with several gadgets and weaponry. He stares at you intently.

* * *

>ask salesman about the sword
It costs 20 euros

>buy sword
You do not have money, so you can not buy that thing

* * *

>ask salesman about the sword
It costs 20 coins

>buy the sword
You hand over cash and take the sword from the salesman.

Nothing is on sale.

* * *

>east
You follow the east path deeper into the forest and got into the house.

house
You are now in the old house. It looks like it has been abandoned for some time, but it is still in good repair. There is a male person standing.

It is salesman, who is standing with a briefcase in his hand which is filled with several gadgets and weaponry. He stares at you intently.

>buy sword
You do not have wallet or money with you
Nothing is on sale.

>north
castle
The walls are made of stone, and the floors are polished marble. There are various doors and hallway leading off in different directions.

You can see a Castle Door here.

* * *

>open wallet
You open wallet, revealing twenty dollar bills.

>take wallet
Amazing, you found money. You can buy items in the old house.

>inventory
You are carrying:
  wallet (open)
    twenty dollar bills

>east
castle
The walls are made of stone, and the floors are polished marble. There are various doors and hallway leading off in different directions.

You can see a Castle Door here.

* * *

>south
house
You are now in the old house. It looks like it has been abandoned for some time, but it is still in good repair. There is a male person standing.

It is salesman, who is standing in front of the table, staring at you intently.

You can also see a table (on which are a sword, a knife and a flaming torch) here.

>buy sword
You hand over cash, now you have 20 dollars remaining. You take the sword from the salesman.

Nothing is on sale.

>inventory
You are carrying:
  a sword
  wallet (open)
    twenty dollar bills

* * *

>east
You follow the east path deeper into the forest and got into the house.

house
You are now in the old house. It looks like it has been abandoned for some time, but it is still in good repair. There is a male person standing.

It is salesman, who is standing with a briefcase in his hand which is filled with several gadgets and weaponry. He stares at you intently.

>east
You follow the east path deeper into the forest.

>west
You can't go that way.

* * *

>east
You follow the east path deeper into the forest and got into the house.

house
You are now in the old house. It looks like it has been abandoned for some time, but it is still in good repair. There is a male person standing.

It is salesman, who is standing with a briefcase in his hand which is filled with several gadgets and weaponry. He stares at you intently.

>east path
I only understood you as far as wanting to (go) East Path.

>East Path
You follow the east path deeper into the forest.

You can't go that way.

>West Path
You follow the west path out of the forest and into the house.

house
It looks like it has been abandoned for some time, but it is still in good repair. There is a fireplace in one corner and a few old pieces of furniture scattered around the room.

A salesman is sitting in one of the chairs, staring at you intently. He is holding a small case filled with various trinkets and gadgets.

You would have to get out of the house first.

>south
You can't go that way.

>north
castle
The walls are made of stone, and the floors are polished marble. There are various doors and hallway leading off in different directions.

* * *

>north
hallway
You can see Door 1 and Door 2 here.

>south
castle
The walls are made of stone, and the floors are polished marble. There are various doors and hallway leading off in different directions.

* * *

>east
You follow the east path deeper into the forest and got into the house.

house
You are now in the old house. It looks like it has been abandoned for some time, but it is still in good repair. There is a male person standing.

It is salesman, who is standing with a briefcase in his hand which is filled with several gadgets and weaponry. He stares at you intently.

>examine table
The table is made of sturdy oak and has a smooth, polished finish. There are various weaponry and gadgets on the desk.

On the table are a sword, a knife and a flaming torch.

* * *

>east
You follow the east path deeper into the forest and got into the house.

house
You are now in the old house. It looks like it has been abandoned for some time, but it is still in good repair. There is a male person standing.

It is salesman, who is standing with a briefcase in his hand which is filled with several gadgets and weaponry. He stares at you intently.

>go east
You can't go that way.

* * *

>east
You follow the east path deeper into the forest and got into the house.

house
You are now in the old house. It looks like it has been abandoned for some time, but it is still in good repair. There is a male person standing.

It is salesman, who is standing with a briefcase in his hand which is filled with several gadgets and weaponry. He stares at you intently.

>north
castle
The walls are made of stone, and the floors are polished marble. There are various doors and hallway leading off in different directions.

You can see a Castle Door here.

* * *

>remove Rose from the vase
You picked roses from the vase and can see the nickel key. Keep the key

>wast
That's not a verb I recognise.

>west
castle
The walls are made of stone, and the floors are polished marble. There are various doors and hallway leading off in different directions.

You can see a Castle Door here.

* * *

>north
(first opening the Castle Door)
hallway
You can see a Castle Door, Door 1 and Door 2 here.

>door 1
You open Door 1.

kitchen
You are in the castle's kitchen. It is a large, well-equipped space with a fireplace, a fridge, and a table in the center.

The old fridge is a large, white appliance with a dented surface and a handle on the door.

>open fridge
That's already open.

>outside
hallway
You can see a Castle Door, Door 1 and Door 2 here.

>door 1
kitchen
You are in the castle's kitchen. It is a large, well-equipped space with a fireplace, a fridge, and a table in the center.

The old fridge is a large, white appliance with a dented surface and a handle on the door.

>examine fridge
In the fridge are a cheescake, a dobosica and a chocolate cake.

>eat cheescake
(first taking the cheescake)
You eat the cheescake. Not bad.

* * *

>east
garage
It is dark in here. In order to see something you must have a flaming torch.

The smart fox is a small, animal with bright, alert eyes, and a bushy tail. It looks sly and cunning, with a sharp, curious gaze that seems to suggest that it is always thinking.

You can also see a table (on which is a vase (in which are a nickel key and Rose)) here.

You can see everything. Now you can search for key
You would have to get out of the garage first.

>ask the fox
What do you want to ask the fox for?

>about cure
You can't see any such thing.

>examine fox
You see nothing special about the fox.

* * *

>west
You follow the west path out of the forest

    *** After finding a way out, you were too scared to go back in the forest. ***

Would you like to RESTART, RESTORE a saved game, QUIT or UNDO the last command?

>examine table
The table is made of sturdy oak and has a smooth, polished finish. There are various weaponry and gadgets on the desk.

On the table are a sword, a knife and a flaming torch.

>examine salesman
You see nothing special about the salesman.

>look table
You can't see any such thing.

* * *

>examine table
The table is made of sturdy oak and has a smooth, polished finish. There are various weaponry and gadgets on the desk.

On the table are a sword, a knife and a flaming torch.

>look
house
It looks like it has been abandoned for some time, but it is still in good repair. There is a fireplace in one corner and a few old pieces of furniture scattered around the room.

A salesman is standing in front of the table, staring at you intently.

>look table
You can't see any such thing.

* * *

>west
You follow the west path out of the forest

    *** After finding a way out, you were too scared to go back in the forest. ***

Would you like to RESTART, RESTORE a saved game, QUIT or UNDO the last command?

>how much is the flaming torch
That's not a verb I recognise.

>ask how much is the flaming torch
You can't see any such thing.

>ask about flaming torch
You can't see any such thing.

>ask about the flaming torch
You can't see any such thing.

>buy
What do you want to buy?

>the flaming torch
Nothing is on sale.

>examine table
The table is made of sturdy oak and has a smooth, polished finish. There are various weaponry and gadgets on the desk.

On the table are a sword, a knife and a flaming torch.

>ask salesman about the flaming torch
It costs 10 euros

>buy flaming torch
Nothing is on sale.

>buy the flaming torch
Nothing is on sale.

* * *

>west
You follow the west path out of the forest

    *** After finding a way out, you were too scared to go back in the forest. ***

Would you like to RESTART, RESTORE a saved game, QUIT or UNDO the last command?

>north
castle
The walls are made of stone, and the floors are polished marble. There are various doors and hallway leading off in different directions.

You can see a Castle Door here.

>east
I can not see in dark

>east
I can not see in dark

* * *

>north
(first opening the Castle Door)
It seems to be locked.

>door 1
You open Door 1.

Kitchen
You are in the castle's kitchen. It is a large, well-equipped space with a fireplace, a pantry, and a table in the center. The smell of cooking food fills the air.

* * *

>north
(first opening the Castle Door)
It seems to be locked.

>west
garden

>east
castle
The walls are made of stone, and the floors are polished marble. There are various doors and hallway leading off in different directions.

You can see a Castle Door here.

>east
garage

* * *

>west
You follow the west path out of the forest

    *** After finding a way out, you were too scared to go back in the forest. ***

Would you like to RESTART, RESTORE a saved game, QUIT or UNDO the last command?

>restart
There was once a young man named Jack who lived in a small village. Jack was often the subject of ridicule and laughter because he was different from everyone else. He was clumsy and awkward, and he often stumbled and fell when he walked. Despite this, Jack had a kind and generous heart, and he always tried to help others whenever he could. One day, a rumor spread through the village that a beautiful princess had been captured by a dragon and locked away in a castle. The villagers were afraid to try and rescue the princess, but Jack knew he had to do something. He knew he was no match for the dragon, but he also knew that he couldn't just stand by and do nothing. Despite the laughter and ridicule of the other villagers, Jack set out on a journey to rescue the princess. You are Jack. You are in forest now.

Igra
An Interactive Fiction by Ivona Kostic
Release 1 / Serial number 230107 / Inform 7 v10.1.2 / D

forest
You are standing in a dense forest. The trees are tall and their branches form a canopy overhead, blocking out most of the sunlight. There is a faint path winding through the underbrush, leading east and west.

(From here, you can move to the east.)

>east
You follow the east path deeper into the forest and got to the old house.

house
You are now in the old house. It looks like it has been abandoned for some time, but it is still in good repair. There is a male person standing.

It is salesman, who is standing in front of the table, on which are  several gadgets and weaponry. He stares at you intently. You can ask him about the things on the table.

You can also see a table (on which are a sword, a knife and a flaming torch) here.

(From here, you can move to the north and the west.)

* * *

>ask salesman about the sword
It costs 20 dollars

>ask salesman how much for things
I didn't understand that sentence.

>ask salesman about things on table
I am selling weaponry and gadget

>buy sword
You do not have wallet or money with you

* * *

>north
castle
The walls are made of stone, and the floors are polished marble. There are various doors and hallway leading off in different directions.

You can see a Castle Door here.

>open castle door
The Castle Door is still locked
It seems to be locked.

>north
(first opening the Castle Door)
The Castle Door is still locked
It seems to be locked.

>west
garden
You are now in the garden.

Here is a huge box made of wood with a hinged lid. It is well-worn, with scratches and dents on its surface. It looks like it has been used for storing things for a long time. You can open it and see what is inside.

* * *

>east
I can not see in dark. The player can not enter garage

>south
house
You are now in the old house. It looks like it has been abandoned for some time, but it is still in good repair. There is a male person standing.

It is salesman, who is standing in front of the table, on which are  several gadgets and weaponry. He stares at you intently. You can ask him about the things on the table.

You can also see a table (on which are a sword, a knife and a flaming torch) here.

>buy flaming torch
You can buy the the sword, the flaming torch or the knife.

You hand over cash, now you have 10 dollars remaining. You take the flaming torch from the salesman.

>north
castle
The walls are made of stone, and the floors are polished marble. There are various doors and hallway leading off in different directions.

You can see a Castle Door here.

>east
You can see everything. Now you can search for key
garage
It is dark in here. In order to see something you must have a flaming torch.

The smart fox is a small, animal with bright, alert eyes, and a bushy tail. It looks sly and cunning, with a sharp, curious gaze that seems to suggest that it is always thinking.

You can also see a cabinet (on which is a vase (in which are a nickel key and a roses)) here.

>examine cabinet
It is made of sturdy oak and has a smooth, polished finish. There is a vase with flowers in it.

On the cabinet is a vase (in which are a nickel key and a roses).

>examine vase
In the vase are a nickel key and a roses.

* * *

>take nickel key
Taken.

>inventory
You are carrying:
  a nickel key
  a flaming torch (providing light)
  a wallet (closed)

>west
castle
The walls are made of stone, and the floors are polished marble. There are various doors and hallway leading off in different directions.

You can see a Castle Door here.

* * *

>door 1
You open Door 1.

kitchen
You are in the castle's kitchen. It is a large, well-equipped space with a fireplace, a fridge, and a table in the center. The smell of cooking food fills the air.

The old fridge is a large, white appliance with a dented surface and a handle on the door. It has three cakes inside.

>open fridg
You can't see any such thing.

>open fridge
That's already open.

* * *

>examine fridge
In the fridge are a cheescake, a dobosica and a chocolate cake.

I am very hungry. I want to eat dobosica

>take dobosica
Taken.

* * *

>eat dobosica
You are poisoned  and have to find a cure if you want to live. The fox has the cure.

You eat the dobosica. Not bad.

>out
hallway
You can see a Castle Door, Door 1 and Door 2 here.

>out
castle
The walls are made of stone, and the floors are polished marble. There are various doors and hallway leading off in different directions.

You can see a Castle Door here.

>east
You can see everything. Now you can search for key
garage
It is dark in here. In order to see something you must have a flaming torch.

The smart fox is a small, animal with bright, alert eyes, and a bushy tail. It looks sly and cunning, with a sharp, curious gaze that seems to suggest that it is always thinking.

You can also see a cabinet (on which is a vase (in which is a roses)) here.

>examine foy
You can't see any such thing.

* * *

>examine fox
Hello smart fox, I am poisoned and need the cure. Can you help me?. Fox says: Yes, but you need to answer this riddle. What invention lets you look right through a wall? 
You see nothing special about the fox.

Enter the answer:

>a window
The fox says: You are right, here is cureThat's not a verb I recognise.

Enter the answer:

* * *

>east
You follow the east path deeper into the forest and got to the old house.

house
You are now in the old house. It looks like it has been abandoned for some time, but it is still in good repair. There is a male person standing.

It is salesman, who is standing in front of the table, on which are  several gadgets and weaponry. He stares at you intently. You can ask him about the things on the table.

You can also see a table (on which are a sword, a knife and a flaming torch) here.

(From here, you can move to the north and the west.)

>ask salesman about things on table
I am selling weaponry and gadget

* * *

>ask salesman about the sword
It costs 20 dollars

>buy sword
You do not have wallet or money with you

>north
castle
You are now in front of castle. In order to get into the castle you need to open the Castle Door.

You can see a Castle Door here.

>north
(first opening the Castle Door)
The Castle Door is locked
It seems to be locked.

>east
It is dark in here, I can not see in dark.
The player can not enter garage

>west
garden
You are now in the garden.

Here is a huge box made of wood with a hinged lid. It is well-worn, with scratches and dents on its surface. It looks like it has been used for storing things for a long time. You can open it and see what is inside.

* * *

>east
You follow the east path deeper into the forest and got to the old house.

house
You are now in the old house. It looks like it has been abandoned for some time, but it is still in good repair. There is a male person standing.

It is salesman, who is standing in front of the table, on which are  several gadgets and weaponry. He stares at you intently. You can ask him about the things on the table.

You can also see a table (on which are a sword, a knife and a flaming torch) here.

(From here, you can move to the north and the west.)

>north
castle
You are now in front of castle. In order to get into the castle you need to open the Castle Door.

You can see a Castle Door here.

* * *

>examine fox
Hello smart fox, I am poisoned and need the cure. Can you help me?. Fox says: Yes, but you need to answer this riddle. What invention lets you look right through a wall? 
You see nothing special about the fox.

Enter the answer:

>jaj
Enter the answer:

>jaj
Enter the answer:

* * *

>west
You follow the west path out of the forest

    *** After finding a way out, you were too scared to go back in the forest. ***

Would you like to RESTART, RESTORE a saved game, QUIT or UNDO the last command?

>south
You can't go that way.

>east
You can't go that way.

>west
You can't go that way.

>north
castle
The walls are made of stone, and the floors are polished marble. There are various doors and hallway leading off in different directions.

>examine castle
You can't see any such thing.

>look
castle
The walls are made of stone, and the floors are polished marble. There are various doors and hallway leading off in different directions.

>north
hallway
You can see Door 1 and Door 2 here.

* * *

>west
You follow the west path out of the forest

    *** After finding a way out, you were too scared to go back in the forest. ***

Would you like to RESTART, RESTORE a saved game, QUIT or UNDO the last command?

>west
You can't go that way.

* * *

>north
castle
The walls are made of stone, and the floors are polished marble. There are various doors and hallway leading off in different directions.

>west
garden

>east
You cannot go east from here.

castle
The walls are made of stone, and the floors are polished marble. There are various doors and hallway leading off in different directions.